####################################          ##########################################################################################################################################################
 #           #   #             #   #                                 #                         #         #       #       # #                 #         #     #                   #       #             #
 ####### ##### # # ##### ##### ### #          ## ################### # ####### ### ########### ####### # ##### # # # ### # # ##### ######### # ####### # ### ######### ### ####### ##### # ########### #
   #   # #                 # #   #             # #     #         # # # #     # #   #     #   #   #     # #   # #   # # #   # #   #   #       # #       #   #   #     # #   #       # #   #       #   # #
## # # # # ####          # # ### # #          ## # ### # ####### # # ### ### # # ####### # # ### # ##### # # # ##### # ### # ### ### # ####### # ######### ### # ### # # # # ####### # ### ####### # # #
 #   # # #                 #   # # #           #     # # #   # # #       # # # #     #   # #     #     # # # #     # #   # # #     # # #     # #           #   # #   # # # #       # #     #       #   #
 ##### # ######          ### # # # #           ####### # # # # # ######### # # ##### # ### ########### # # # ####### # ### # # ##### # # ### # ##### ####### ### #          ###### # ####### ######### #
     # #     #           # # #   #                     #   #   #       #   # #     # # #   #           #   #         #     # # #   # # #   #   #   # #   #   #   #           #             # #     #   #
 ### # # ### #           # # #######          ######## ####### ####### # ### ##### # # # ######### ################### ##### # # # # # ### # ### # # # # # ### ###           # ############# # ### # ###
 # #   #   #             #   #                       # #     #   # #   #   #     # # #           #     # #     #     #   # # #   # # #     # #   # # # # #                   # # #           #   # #   #
 # #####                 ### ########### # ######### ### # ##### # # ### # ##### ### # ######### # ### # # ### # # # ### # # # ### # # ##### # ### # # # ###                ## # # ########### # # ### #
                                     #   #       #   #   #     #   # # # #           # #     #   #   # #           #   #   # # #   # # #   # #   # # # #                       # #     #     # # #   # #
########                          ## # ### ####### ### ####### # ### # # ###########           ######              ####### # ### # # ### # ##### # ### #####                 ### ##### # # # # # # ### #
                       #           # #   # #           #     #   #   #         #                                       #   #   # # #     # #     #     #                       #     # # # # # # # #   #
                       #           # ### # #          ## ### ##### ########                    ######              ### # ##### # # ####### # ####          #                ## # ##### ### ### # ### ###
                                   # # # # #           # #   #   # #                           #                     #   #     # #   #   #   #             #                 #   #   #   #     #   #   #
                       #          ## # # # #          ## ### # # # # ######                                        # ##### ##### ### # # ##### ##          #          ## ##### ### # ### ####### # ### #
                       #           # #     #               #   # #     #                                           #     # #       #   #   #                             #   # #   #     #     # # #   #
                       #           # #######               ##### ##### # ##                                        ##### # # ##### ####### # ####          #          #### # ### ######### ### ### # ###
                                   #       #               #   #   # #   #                                         #     # # #     #     # #   #           # #   # # #   # #     #       #   #     # # #
            #                      ####### #               ### ### # #####                                         # ##### ### ##### ### # ### ##          # ### ### # # # ####### # ### ### ##### # # #
                             #   #       #                     #   #     #                                       #   #   #     #     #   #   #             # #   #   # # #     # # #   #     #     #   #
             ####          ##### ### #######                   # ### ######              ##              # # # # ##### # ####### ##### ##### ####          # # # # ##### ##### # # ### ####### ####### #
             #                     #         #                 # #                                         #   #       #         #   # #   # #             # # # #           # # #   #       #     #   #
 #           # ##          ########### # ### #                ## # ##### ### ### # ### # ##              ####################### # # # # ### # ####### ### # # ### ########### # ### ####### ##### # ###
 #           # #           # #           # #                     #     #   #   # #   # # #                             #       #   # #   #   #     #   #   # #     #           #   #   #   #     # # # #
##           # #           # #           # ###                 ####### ### # ### # ### # # ###                  ## ### # ##### ##### ### # ### ### # ### ### ####### ############# ### # # ##### ### # #
             # #             #           #         #           #     #           # #   # # # #                     #   #     # #   #   # #   #   # #           #   #             #     # #     #     # #
 ####### ##### #           # #          ############          ## ### #          ## # ### # # ##                  ########### # # # ### ##### ### # ########### # # # ########### ### ### ##### ####### #
   #     #   #   # # # #   # #               #     #               # #           # #   # #                               # # #   #   #   #   # # # #     # #   # # #   #       #   # # # #       #     #
 # # ##### # ### # # # # # ###           ### # ### #          #### ###           # ### # #                         ### # # # ##          # ### # # # ### #          ## # # ####### # # # # ##### # ### #
 #       # #   #   #   # #                 #     #   # # # #     # #             #   # #             #                 # # #             # #     #     # #           #   #           #   #   #   #   # #
###### ### ### ######### #####          ## ######### # # # # ##### # #           ### # # #           #             ##### # ###           # ############# #           # ###           ### ### # ##### # #
     # #   # #   #       #   #           #   #     # #   # # #   #   #             # # #                               #   # #           #               #           # #               # #   #     # # #
 ### ### ### ### # ######### #           ### # ### # ##### ### # # ###          ## # # ###          ##             ### ### # ##          #################           # # #          ## # # ####### # ###
 # #     #         #   #   #   # # # #   #   #   #   #   #     # #   #             # #   #             #             #                   #   #           #                             # # #     # #   #
 # ####### ######### # # # # ### # # # ##### ### ### # # ####### ### #          ######## #          ## #           # ##########          # # # ####### ###                           ### # # ### # ### #
 #     #   #     #   #   # #     # # #     #   # #   # #   #   # #   # # # #     #       #           # #                 #                 #     #   #   #                           #   # # #   # #   #
 ### ### ### # # # ####### ##### # # ##### ### # ### # ### ### # ##### # # # ### # #######           # ##          ##### # ####          # ####### # ### #                           ##### # # ### # # #
   #       # # # # #   # # #   # # # #   # #   #   # # # #     #       #   # #   #   #     #   # # # #             #   # # #             #   # #   #     #                           #   # # # #     # #
 # ####### # # # # # # # # # # ### # ### # ####### # # # ##### ######### ##### # ### # # # # ##### # ####### ##### # ### # # ### ### # # ### # # ######### # # ###                   # # # # ### #######
 #       # # # # # # # # #   # #   # #   #         #   #     #     #     #     # # # # # #   #   # #   #           #   # # #   # #     # # #   #             # # #           # #   # # # # #     #     #
 ####### # ### ### # # # ##### # ### # ################# ##### ##### ####### ### # # # # ### # # # ### #           # # # # ### # ####### # ### ############### # #           # ### # # # # # ##### ### #
 #       #     #   #             #   #                       # #     #       #   # # # # #   # #                   # #   #   # #     #   #   #   #     # #     #             #   # #   #   #   #   # # #
 # ########### # ###          #### ### ####### ############# # # ##### ####### ### # ### # ### #                  ###### # # # ##### # ### # ### # # # # # ##### ##          # # # ##### ####### ### # #
 # #   #     # # # #           # # #     #   #     #                 #     #       # #   # # # #                       #   # # #     #   # # #   # # #   # #   # #   # #     # # #   #   #     #     # #
 # # ### ### # # # #           # # ####### # ##### #######           ### # ####### # # ### # # #                  #### ####### # ####### # ### ##### ##### # ### ### ### ####### ### ##### ### ##### # #
 # #       #   # #               #         #     #   #   #             # #       # # #   #   # #                     #         #   #   # #   #   #   #   # #     #   #   #         #   #   #   #     # #
## ############# ###          ## ############### ### # # #          ## # ####### # # # # ##### #                  ## ############# ### # ### ### # # # # # # ##### ### ##### ##### ### # ### # # ##### #
   #   #       #   #               #           # # # # # #           # #   #   # # # # #     # #                   # #         #   #   #   #       # # #   # #       #     #     #   # # # # # #   # # #
 # # # # ##### ### #               ### ##### # # # # # # #           # ### ### # ### ####### # #                  ## # ####### # ### ##### # ######### ##### ####### ##### # ### ### # # # # ##### # # #
 # # #   #       #                   # #   # # # #   # #             #   #   # # #   #     #   #           #     #   # # #   # #   # #     # #   #     # #   #         # # #   #   # #   # # #     # # #
 ### ##### #########               # # # ### ### # ### # #          #### ### # # # ### ### # ###           # ### # ### # # # # ### # # ####### # # ##### # ### ##          ### ### ####### # # ##### # #
 #   #   #                         # # # #   #   #     # #             # # # # # # #   # # #     #   # #   #   #   #   #   #   #   # #         #   #     # #                 #   #         #   #   # # #
 # ### # ###                       # # # # # # ###########          #### # # # # # # ### # # ##### ### # ##### ##### ######### # ### ############### ##### # ####          # ### ##### # ####### # # # #
       # #                           #   # # #   #       # # # #     #   # #               # #   # #   #     #   # #         #   # #         # #           # #             # #   #   # #         #   # #
#### ##### #                       # ##### ##### # ##### # # # # ### # ### ###           ##### # # # ####### ### # ######### ##### # ### ### # # ########### # ##             #### #          ###### # #
   # #     #                       #       #   #   #     # # # #   #   #                       #   #       # # #     #   #   #     # # # # #   #           # # #                   #             #   # #
 # ### #####                       # ####### # ##### ### # # ##### ######### ##          ######### ####### # # ##### ### # ### ##### # # # ### #           # # #              ######          ## # ### #
 #     #                         # # #   #   #     # #   # #     #       #                   #   # #   # #   #       #               # # #                 # # #                 #             #   # # #
 ####### ###                   ### # # # # ####### # ##### ### ######### ######          ##### # # # # # ##### ####### ##          ### # #######           ### #              ## # #           ##### # #
   #   #                       #   # # #   #     # #       # #         #   #                   #   # # #     #   #   #                 #       #                               #   #           #     # #
## # # #                       # ##### ##### ### # ##### ### ####### # ### # ##          ######### # # # ### ### # # # #           ####### ### #                  ##           #####           # ##### #
   # #                         # #     #   #   #       #     #       #   #   #                     # # #   #   # # #   #             #   #   # #                                   #           # #     #
 #######                       # # ### # # ########### ####### ###############                     # # #          ######           # # # ##### #                   #          #### #          ## # #####
       #           #           # # #   # #         # # #     # #               # #                 # # #               #           #   # #   #                     #               #             #     #
###### #          ##           # # ### # ######### # # # ### # # ####### ##### # # ### #           # # #           ### #           ##### # # ###                   ####### # # ##### ####### ### ##### #
       #                       # #   # # #       # #     #     # #     #     # #     # #             # #           #   #           #     # #                       #     #   #       #     #         # #
 #######           #           # ### # # ### ### # ####### ##### # ### ##### # ####### ##          ### #           # ####          # ##### ######### # #          ## ################# ### # ######### #
     #                 #     #   #   # # #   # # #     # # # #   # # # # #   #   #     #           #   #           # #       # # # #   #   #   #       #             #     #           # # # #     #   #
 ### # #           ##### ### ### # ##### # ### # ##### # # # # ### # # # # ##### # #####           # ###          ## # ##### ### # ### ### # ### #######           # # ### # ########### # ### ### # ###
 # # # # # #     # #   #   #   #   #   #   #   # # #   #   # #     #     #   # # # #               #   #             #     #   # #   # #   #     #   #     #     # # #   # #       #     #     #   #   #
 # # # # ### ### ### # ### ### ### # # ##### ### # # ##### # ####### ####### # # # # ####          ### #           ##### # ### # ### # # ### ##### # # ##### ##### # ### # ##### # # ########### ##### #
   #   # #   # #     #   # #   #   # #         # # # #   #     # #   # #     #     # #     #   # # # #                 # # #     # # # #   #     # #   #   # #     # #   #     # # #           #     # #
## ##### # ### ######### # # ####### ######### # # # # # ##### # # ### # ######### # # ##### # # # # ######### ####### # # ####### # # ### ####### ##### # # ##### # # ####### ### # ##### ######### # #
 #   #   # #   #     #   # # #       #     #   # # #   #     #   #   # #       #   # # #   # # # # #         #     #   # #     #   # # #   #   #   #     # #       # #       #   # # #     #         # #
 ### # # # # # # ### # ### # # ########### # ### # ######### ####### # ####### ##### # # # # # ### ### ########### # ######### # # # # # # # # # ##### # # ################# ### # ### # ### ######### #
     # # # # # # #   # #   # #   #   #   # #     #         # #     # #       # #     # # #   #   #   # #       #   #           # #   # # # # # # #   # # #         #         #   #   # # #   #         #
 ##### ### # # ### # # # ### ### # # # # # ####### ####### # # # ### ####### # # ####### ####### ### # # ##### # ##################### # ### # # # # ### ######### # ######### ##### # ### ########### #
     #       #     # #     #       #   #           #       #   #             #           #           #       #                         #     #     #     #           #               #                 #
########################################################################################################################################################################################################