########################################################################################################################################################################################################
 #         #   #     #           #     #                 # #     #     #             #   #     #           #   #             #     # #                 #       #                           #   #     # #
 # ####### ### # # ### ####### # # ##### ####### ##### # # # ### # # ### ### ####### # # # ### ### ####### ### # # ######### # # # # # ############# # # ### # ##### ####### ############# # # ### # # #
 #   #   #   # # #     #     # #   #       #   # #     # # # # #   #     #   # #     # # # # # #   #   #       # #   #   #   # # #   #   #         # # # # # #     #     #   #           #   #     #   #
 ### # # ### # # ######### # # ##### ####### # ### ##### # # # ########### ### # ##### # # # # # ### # ######### ### # ### ### # ### ### # ##### # # ### # # ##### # ### ##### ######### ############# #
     # #   # #       #     # #     # #       # #   #       # #         # #   # #       #   # # # #   #             # #   # # # #   # # # #   #   # #   #   # # #   #   #               # #   #   #     #
######## # # ####### ### ######### # # ####### # ######### # # ####### # ### # ############# # # # ################# ### # # # ### # # # ##### ### ### ### # # # ############### ####### # ### # # #####
         # # #     #     #   #   # # #   #   # # #       # #   #   # #     # #       #   #     # # #   #     #       #   # #   # # #   #   #   # # # # #   # #   #   #   #     # #       #   # #   #   #
 ### ####### # ### ####### # # # # # ### # # # # # ##### ####### # # ##### # ##### # ### # ##### # # # # ##### ####### # # ### # # ### ### # ### # # # # ### # ### # # # # ### ### ####### # # ####### #
   # #     # # #     #   # #   #   #   # # #   #       #     #   #       # #   #   #   # #   #     # # # #     #     # # #   #   #   # # # # #   # # # # #   #     #   #   #     #   #     # #   #     #
## # # ### # # ##### # # # ########### # ##### ##### ##### ### # ######### ### # ##### # ### # ##### # # # ##### ### # # ### ### ### # # # # # ### # # # # ##### ############### ### # ##### ### # #####
   #   #   # #   # #   # #     #       #     #   #   #   #     # #   #   # # # #     #   #   # #     #   #   #     #   # #   # # # # #   # # #     # # # # #   # #           # #   # # #     #   #     #
 ##### # # # ### # ##### ##### # ########### ### ##### # # ##### # # # # # # # ##### ##### ### # ####### ### ##### ##### # ### # # # ##### # ##### # # # # # # # # ######### # ### # ### ##### ### ### #
 #   # # # #   # # #   #     # # #     #   #   #       # #     #   # # #     #     #     # #     #     # # #   #   #     #   # #   #       #     #   #   # # #   # #       # #       #   #   # #   #   #
## # ### # ### # # # # ##### # # # ### ### ### ######### ####### ### # ########### # ### # # ######### # # ### ### ######### # ### ############# ### ##### ####### # ### ### ######### # # # # # ### # #
   #   # #   # # #   #       # # #   #       #   # #   #       #   #   #         # #   # # # #       #   #   #   #         # #     #     #     #   #     # #     # #   #   #       #   # # #   #   # # #
 ##### # ##### # ####### ##### # ### ####### ### # # # ####### ### ######### ### # ##### # ### ##### # ### ##### ##### # ### # ##### # ### # # ### ####### # ### # ####### ####### # ##### ####### # ###
   #   # #     #       #     # #     #   #   # # #   # #       #   #   #     #   #     #       #     #     #     #     # #   #   #   #   # # #     #   #   #   #   #         #     #   #   #     # #   #
 # ### # # ##### ##### ##### # ####### # # ### # ##### # ####### ### # # ##### ####### ####### ##### ##### # ##### ##### # ##### ### ### # # # ##### # # ##### ##### ####### # ####### # ### ### ##### #
 #   #   #     #     # # #   #     #   # # #   # #     # #           # #   #   #   # # #     # #   # #   # # #       #   # #       #   #   # # #     # #   #   #     #       #     #   #   # #   #     #
 ### ######### ####### # # ### ##### # ### # ### # ##### # ########### ### # ### # # # # ### ### # # # # ### # ##### ### # ####### ### ##### # # ##### # # # ### ##### ########### # ##### # # ### ### #
   #         #         # #   #   #   #       #   #     # # #   #     # #   #     # # #   #   #   # #   #     # #   #   # #     #   # # # #   # # #   # # #       #   #   #       # #     #   # #     # #
############ ########### ### ### # ########### ### ### # ### # # ### # # ######### # ##### ### ### ########### # ##### # ##### # ### # # # ### # # ### # ######### # ### # # ##### # # ####### # ### # #
       #               #   #   #   #   #     # #     # #     # # # #   #     #   # #     #       #   #   #     #     # #   #   # #   #   #   # # #   # #   #       # # #   # #     # #     #   # #   # #
 ##### # ############# # ##### ### # ### ### # ##### # ####### # # ######### ### # ### ############# ### # ####### # # ##### ### ### ### ### ### # # # ### # # ##### # ##### # ####### # ### ### # ### #
 #   #   #   #         #     #   #   #   # # #     # #     #   #   #       # #   #   #     #       #   #   #   #   # #     #   #   #     #   #   # # # #   # # #   # #   #   #       # #       # #   # #
 # # ##### # # ####### ##### ### ### # ### # # ### # # ##### ##### # ##### # # ##### # ### # ##### # # ### # # # ### ##### ### ### ####### # # ### # # # ### ### # # ### # ######### # ####### ##### # #
 # # #   # # #   #   #     # #   #   # #     #   # # # #   #     #   #       #       #   # # #     # #   # # # # #   # #   # # # #         # #   # #   # # #     # #   # #   #     # # #   # #       # #
 # # # # # # ##### # ##### # # ### ### # ####### # ### # # ##### ### ############### ##### # ### ####### # # # # ### # # # # # # ### ########### # ##### # ####### ### # ### # # # # ### # # ######### #
   #   #   #       # #   #   # #   # # # #       # #   # #     #   # #             # #   # #   #         #   # #   #   # # # # #   # #           #   #       #     #   #   # # # # #     # #         # #
 ################### # ##### # ### # # # # ####### # ### ##### ### ### ########### # # # # ### ######### ##### ### # ### # # # # ### # # ########### ######### ##### ##### # ### # ####### # ##### ### #
 #           #   #   #       #   #   # # #   #     #   #     #   #     # #         # # #     #   #   #   #   # #   # #   #   # # #   # # #   #     # #         #   #   #   #     #   #   # #     #   # #
 # ##### ### # ### ### ######### ### # # ##### ##### # ##### ### ####### # ######### # ######### # # ##### # # # ##### ####### # # ### ### # ### ### # ######### # ### # ########### ### # ### ##### # #
 #   #   #   #   # # #   #       #   # #   #   #     #     #   #   # #     #         #       #   # # #   # # #   #     #       # # # #     #   # #   # #         # #   #       #   # #   # #   #   # # #
 ### # ### ##### # # # ### ########### ### # ####### # ####### # # # # ##### ############### # ### # # # # # ##### # ### ####### # # ######### # # ### # ######### # ####### # # # # # # # ##### # # # #
 #   # #         # #   #   #           # #   #     # #   #   # # #   #   #   #     #     #   #   # #   #   #     # # #   # #       #       #   # #     # #       # # #       #   # # # # # #     # #   #
 ##### ######### # ##### ##### ######### ### # ### ### # # # # # ####### # ##### # # ### # ##### # ############# # ### ### # ######### # # # ### ####### # # ### # # # # ######### # # # # # ##### ### #
     #         # #       #     #       #     # # #   # #   # # #         #       #   #     #     # #   #       # # #   #     #   #   # # # # #     #     # #   # #   # #         # # # # # #   # #   # #
#### # ####### # ######### ##### ##### ####### # ### ####### # ############################# ### # # # ### ### # # # ####### # # # # ### ### # ##### ######### # ############### ### # ### ### # ### # #
     #   #   # #       #   #         #   #     #   #       #   # #                 #         #   #   #   #   # # # #       #   #   # #   #   #   #   #         # #     #       #   # # #   #     #   # #
 ######### # # ####### # # # ########### # ####### ####### # ### # # ############# # ######### ######### ### ### # ####### ######### # ### ##### # ##### ####### ### # # ##### ### # # # ### ##### ### #
     #   # #   #     # # # # #   #   #   # #     #     #   # #     # #           #   #                 #   # #   #     # # #       #   #   #     # #     #           #   #   #   # #   #     #   # #   #
#### # # # ######### # # ### # ### # # ### # ### # ##### ### # ##### ######### # # ################### ### # # ### # # # # # ##### ### # ### # ### ### ### ################# ### # # ######### # # #####
   #   #   #         # #       #   #   #   # #   # #     #   # #     #   #   # #   #   #             #   #   # # # # # # # #     #     #   # # #   #   #   #       #       #   # # # #         #   #   #
## ######### ####### # ####### # ### ### ### # ### # ##### ##### ##### # # # ####### # # ########### ### ### # # # # # # # # ############# # ### ### ####### ##### # ##### # ### # # # ######### ### # #
   #     #       #   #       # #   # #   #   #     # #   # #     #     #   #   #     # #           # #   #   # #   # #   # # #   #         # #   #   #   #   #     #   #     #   #   #     # #   #   # #
 # ### ### ##### # ######### ##### # # ##### ####### # # # ### # # ####### ### # ##### ########### # ##### ### # ### ### # ### # # ######### # ### ### # # ### ##### # ####### ### ####### # # ### ### #
 #   #   #     # #   #   #   #     # #     #   #     # # # #   # #   #   #   #   #         # #     # #     #   # # # #   #     #   #   #     #   #     # # # # #     #   #   # #       #   #   #   # # #
 ### # # # ##### ### # # # ### # ######### # # # ##### # # # ####### # # ### ##### ####### # # ##### # ##### ### # # ############### # # ### ### ####### # # # ######### # # # ####### # ####### ### # #
   # # #   #     #     # # #   # #       # # # # #     # # #         # # #   # #   #     #   # #   #   #   #   #   #               # #   #     #   #   #     #   #     # # # # #   #   # #           # #
 # # # ##### ############# ### ### # ##### # # # ##### # # # ####### # # # ### # ### ### ### # # # ### # # ### ### ########### ### ### ### ### ### # # ######### # ### # # # # # # # ### # ########### #
 # # #   #   #   #   #   #   #   # #     # # # #   #   # # #   #   # # # #   # #     #   #   # # #   # # #     # # #     #   # #     # # #   # #   # #   #     # #   # #   #   # # #   #         #   # #
## # ##### ### # # # # # ### # # # ##### # ### ### # ### # ### # # ### # ### # ####### ### ### # ### ### ####### # # ### # # # ##### # # ### # # ### ### # ### # ### # # ##### # # ##### ####### # # # #
   #     #     # # #   #   # # #       #       #   # # # #   # # #     # #     #     #   # #   # #       #   #   #   # # # # #   #   #     # # # #   # #   #   #     # # #   # # #     # # #   # # #   #
 ####### ####### # ##### ### # ############### # ### # # ### ### ####### ##### ### # ### ### ### ########### # # ##### # # ##### # ######### # # ### # ##### ####### # ### # # # ##### # # # # ### ### #
 #               # #   #   # #   #     #     # # #   # # #   #   #   # #     # #   #   #     #   #   #     #   #   #     #     # #           # #   # #   # #       # #     # # #   # # #   # #     # # #
 ################# # # ### # ##### ### # ### ### # # # # # ### ### # # ##### # # # ######### # # # # ### # ####### # ####### ### ############# ### # # # # ####### ### ##### # # # # # # ### ####### # #
                   # #     #   #   # #   # #     # # #   # #   #   # #     # #   # #   #   # # # # #   # #         # #     # #   #               #   # # #       #   #   #   # # # # # # #   #     #   #
 ################### ######### # ### ##### ####### # ##### ### # ### # # ### ####### # # # ### ### ### # ######### # # ### # # # ##################### # # ##### ### ### # ### ### # # ### ### ### # ###
         #       # # #       #   # #           #   # #     #   # #   # #   #         # # #   #     #   #   #       #   # # # # # #     #   #         # # # #       # #   # # #     # #     # # # #   # #
######## ### ### # # # ##### ##### # ### ##### ##### # ##### # # # ### ### ########### # ### ##### # ##### ##### ####### # # # ### ### # # # ### ### # # # # ####### # ### # ####### ####### # # ##### #
       #     # #   #       #       # # #   # # #     #   #   # # # #     #       #   #   # #     # #     # #   #     #   #   #       # # #     # # #   #   # #       #   # # #           #   #         #
 ### # ####### ### ####### ### # ### # ### # # # ####### ### ### # ##### ### ### # # ##### ##### # ##### # # # ####### # ### ######### # ####### # ### ####### ########### # # ####### # ### ######### #
   # # #       # # #     #   # # #   #   # #     #     # #   #   #   # # #   #     #   #       # #   #   #   #   #     #   # #       # # # #     #   # #     #     #     # #   #     # #           #   #
## # ### # ### # # # ### ##### # # ### # # ####### ### # # ### ##### # # # ############# ### # # ##### ######### # ##### ### # ##### # # # # ####### # # ### ##### ### # # # ### ### # ### ######### ###
 # #     #   #   # # #       # # #   # # #   #     #   # #     #     #   #       #       # # # #     #   #       #     #   # # #       #   # #     # # #   #     #   # #   #   # #   # #   # #       # #
 # ######### ### # # ####### # # ### # # ### # ##### ### # ##### ####### ####### # ####### # ####### # # # ##### ##### ### # # ### ####### # # ### # # ### ##### ### # ### ##### # ### # ### # ####### #
 #       # #   # # #   #       #   # # # #   #   # #     #     #       #       # # #       #     #   # # #   #   #   #   #   #   # #       #   # # #     # #   #   # #   # #     # #   #   # # #   #   #
 ####### # ### ### ### ####### ##### # # # ##### # ########### ####### ##### ### # # ##### ##### # ### # # # # ### # ### ####### # # ########### # # ##### # ##### # # # ### ##### # # ### # # # # # ###
   #     #   #   #   #     #   #     # # #   #   #       #     #   # # #     #   #   #       #   #   # # # # # #   #   # # #     # # # #       # # # # #   #     #   # #     # #   # #   #   #   # #   #
 # # ##### ##### ### ##### ##### ####### ### # ### ##### # ##### # # # ####### ####### ####### # ### # # # # ### ##### # # # ####### # # # ### # # # # # ####### ####### ##### # ### ### ### ##### # # #
 # # #     #   #     #   #     # #         #   # # #   #   #     #   #       #   #     #   #   #   # # # # #     #   # #   # #       #   # #     # #   #           #   #       # # #   #   #   #   # # #
 # # ### # # # ####### ####### # # ####### ##### # ### ####### ##### ####### # # # ####### # # ##### ### # ####### ### ### # # ########### # ##### ############### # # ####### # # ### ### ##### ##### #
 # #   # #   #       #       #   #       #     #     #         #     #     # # #   #       # # #   #     # # #       #   # # # #           #   #   #         #     # #       # # #   # # #     #   #   #
 ##### ######### ### # # ########### ### ##### ##### ### ######### ### ### # # ######### ### ### # ####### # # ##### # ### # # ####### ####### # ### ##### ### ##### ####### ### ### # # ##### ### # # #
     #   #       #   # # #     #   # #   #   # #   #     #   #   # #   #   # #     #   #   #   # #       # # # #   # #     # #         #     # #   #   #   #   #         # #   # #   # # #   #   #   # #
## ##### # ####### ### ### # # # # ### ### ### # # ####### # # # # ##### ### ##### # # ### ### # ##### ### # # # ### ####### ########### # ### ### ### # ### ######### # # ### # # ### # # # ### ##### #
   #     # #     # #       # #   #   # #   #   # # #       #   # #       #   #   # # #     # #   #   # #   #     #   #   #   #     #   # #   #   # #   # #   #       # # #   #   #     # # #     #     #
 ### ##### # ### # ######### ####### # # ### ### # # ########### ######### ### # # # ##### # ##### # # # ######### # # # # ### ### # # # ### ### # # ### # ### ##### ### # ####### ##### # ####### #####
           #   #             #         #         #   #                     #   #     #             # #             #   # #       #   #     #     #     #       #         #               #             #
########################################################################################################################################################################################################