############################################################################################   ################################################################################################   ######
 #           #       #           #               #     #             #       #             #       #         #             #     #       #   #         #         #   #                 #   #       #   #
 # ##### ### ### ### #     # ### ############# # # ### # ##   ###### # # ##### ### ####### #   # # # ####### ### # ####### ### # # # ### # # # ####### ##    ### ### # ####### #######     # ##    # # #
 #     #   #     # # #     #   #             # # # # #   #         #   #       # # #     # # #   #   #     #   # #   #   #   # # # #   # # #   #   #         #   #   # # #     #     #       #   # # # #
 ### # ### ####### #   # ##### ##########    # # # # ##### # ################# # #    ## # # # ####### ####### # ### # # ### # # # #   # # ####### # ####   ## ### # # # # ####### ###    #### ##### # #
 #   #   # #       #         # #       #     # #   #   #   #         #       #   #       # # #       #   #   # # #   # #   #   # # #     # #       # #       #     # # # #   #   # #     #   # #     # #
 ### ##### ##### ###   ##### # ##### # ##    ##### # # # ######### ### ##### ### #     ### # ####### # #   # # ### ##### ####### ### #     ##### ### # ##### ######### # ### # # # #     # # # # ##### #
   # #   # #   #           # # #     #     #     #   # #       # # #   #     # # #   #   # #       # # #   # # #   #     #       #   #         #     #     #           #   #   # # #     # #   # #   # #
## ### # # # # # ######### # # # ######### ##### ##### ####### # # # ##### ### # ### ### ##### ##### # #   # # # ### ### # ####### ###    #### ##    ##### ############### ##### # # ### # ##### # # # #
   #   # #   # # #   #   # # # #   #   #   #     #   #   #       # #     # #   #       #       #   # # #   # #   #   #   #         # # # #   #           # #       #     #     # # #   # # #   # # # # #
 #   ### ##### ### # # # # ### # # # # #   # ##### ##### ######### ##### # ### # ##### ######### # # # # ### ##### ##### #   # ##### # # # # ### # #####   # ##### ### # # ##### # ### ### # # # ### # #
     # # #   #     # # #   #   # # # # #   # #   #     # #     #   #   # #   #       # #       # #   #   #   # #       # #     #     # # #   #   #           #   #     #   #     #     #   #         # #
##   # # # # ### ### # ##### ### # # # ##### # # # ### # # ### # ### # # ### # #   # ### ##### # ####### # # # # ##### # # # ### ##### # #   # ### #####   # # # ########### ##### ##### ###    #### # #
         # #   # #   # #     # # # # #       # # # # # # #   # #   # #   #   # #   #   #     # # #       # # #   #     # # # #         # #   #   #   #     # # #     #     #   #   #             #   # #
 ####    # ### ### ### # # ### # # # ##### ##### # # # # ### # ### # ##### ##### ##### # ### # # # ####### # ### # # ##### # # ######### # ##### #   # # ### # ##### # ### # #   ############# # # ### #
 # #       # # #   #   # # #     #   #   #     #     #       #   # #   # #   #   #   # # #   #   # #   #   #   # # # #   #   # #       # # #   #       #   # #   #     #   # #     #         # # #   # #
 # # ####### # # ### ##### ##### ##### # ##### ##### ########### # ### # ### # ### ### ### ####### # ### ##### ### ### # ##### ### #####     # ###   ##### # ### ####### #####   # # ####### # # ##### #
 # # #     # #   #   #     #   # #     # #   #   #       #   #     #   # #   #   #   #   #   # #     #   #   #   # #   #     #   #               #   #   # #   #     #   #     #     #   #   # # #     #
 # # # ### # ##### ##### # # #   #    ## # ##### # #####   # ####### ### # ### # ### ### ### # # ##### ### # ### # # ####### ### # #####    #    # # # # # ### ##### ### # #####   ###      ## # # ### #
 # #   # # # #   #   #   # # #         # #       # # #     #         #     #   #   #   #     #   #     #   #   #   # #     #       #       #     # # # # #       # #   #   #                   #   # # #
 # ##### # # # # ### # ####      ##   ## ####### # # # #   ########### ########### # ######### ### ########### # ### ##### ###     ######### # # # # # # ####### # ### ######### ######      # #   # # #
 #     #   # # #   # # #         #     #   #   # #   #   #     #       #     #     #         #   # #           # #   #       #         #     # #   #   #       #     #           #         # # #   #   #
 # ### # ### # ### # # # ##   ## ##### ### # # # ### ### # ### ####### # # # #     ####### # ### # # ### # ##### # ### ####    # ##### # ##### #########   ### # ######    ####### ######### # #   # ###
 #   # #     #   # # # #   #   #     #   #   # #   # # # #   #       # # # #               #   # # # # # # #     #     # #       #       #   #             # # # #           #     #       # # # # # # #
 # # # ##### # ### # # ### # # ##### # # ##### ### # # # ### ####### # ### #####   # ##### ##### # # # # ### ########### #    ##   ####### ########### ### # # ### ### # # # # ##### ##    # # ### # # #
   # #   #   # #   # #     # # #   #   # #   # #   #   #   # #       # #   #     #   #   # #     # #   #     #   #       # #         #     #     #     #   #     # # #   # #   #     #     # #   #     #
  ## ##### ### #   # # ##### # # # ##### # # # ### ####### # # #    ## # ### ### # ### # ### ##### ### ####### # # ##### # # # #   # # ##### ### # ###   ####### # # ##### ####### ###     # ### #######
   #         # #   # #   # # # # #   #   # # #   #     #   # # #     # # #   #   #     #     #   #   #       # # #   #   # # #   #   # #     # # # # #   #     #   #     # #     #     #   #   #   #   #
## # ######### # # # ### # # # ##### # ### ##### #   # #     # ##### # # # ### ##### ######### ##### ####### # # ### # ### # ### #   # # ##### # # # #   ### # ####### # # #     ##### # ##### ### # # #
   #   #       # # #   # # # #     #       #     #           #     # #   #   #     # #     # #     #   # #   # #     # #   #   # #     #   #   #   # #     # #         # # #     #   # #   #     #   # #
 ##### # ##    # ##### # # # ##### ######### ##### #    #   ## ### # ### ### ##### # # ### # # # # #   # # ###    #### # ### ### #   # ### ### ##### ##### # ### ######### ### # #   # ### # ######### #
 #   # # #     #       # # #     #         # #           #   #   # #   #   # #   # #   # # #   # # #   #   #       #   #     #   #   #             #   #   # # #   #     #     #     #   #     #   #   #
 # # ### # #######   ### # ##### ##   #### # # #######   # # ##### # # # ### ### # ##### # # ### # # ####### ##    # ###    ## ##### ############# ### # ### # ### # ### ########### ########### # # # #
 # #     #     #       #       #             # #   #       # #     # #   #   #   # #     # # #   # #     #   #   # #           #   #     #             #   # #   # #   #   #       #       #     # # # #
 # ####### ### # ##### ####### ###    ######## # # #####   # # ### ####### ### ### # # # # ### # #   # # # ### ### ####### # ##### ##### # ############### # # # # #   # ### ### ######### # ##### # ###
 # #     # # # #       #       # #           # # #           # #   #     #   #   # # # # #     # #   # # #     # # #     # #     #   #   #   #     #   #   # # # #     # #   # #       #   # #     #   #
 # # # ### # # #########   #            #    ### ####### ### # # ### ### ### ### # ### ##### #####   # # ####### # # ### # ##### ### # ####### ### # # # ### # #####   # # ### ##### ### ### # ##### # #
   #       # #   #   #             #         #         #   #   #   #   #   #     #   #       #     # # #   #     # #   # #     #   #           # #       # # #       #   # # #   # # #   #   #   # # # #
 ###    #### # ### # #    ##       # ### # # #     # ##### ### ####### # ####### ### ######### ##### # # ### # # # ### # ##### ### ############# ##   #### # ###   ###   # # # # # # # ##### ### # # # #
 #         # #     # #     #     # #     # #       # #   #   # #       #       # # #     #   # #   # # # #   # # # #   #     #   #     #     #         #   #   #     #     #   # # #         # # #   # #
 ### ### # # ####### #     ########### ### #   ##### # # ### ### ######### ##### # ##### # # # ### # # # # ### ### # ########### ##### # ### #    #### # ##### ##### # # ### ### # ####    ### # #   # #
   #     #   #     #   # #           #   #     #   # # #   #   #   #     #     #   #   #   #   #   # # # #   #   # # #               #   #   #       #   #   #     # #   #   #             #   # #     #
## ######### ##### ##### ########### ######### # # # # ### ### ### # ### ##### ### ### ##   #### ### ### #   ### # # # #######   ######### ### ##### ### # # ####    ##### ### ############# # # ### # #
 #   # #     #   #   #   #     #   #         #   #   # # #   # #   # #       #   #   #       #     #   #         # # # #               #   # #     #       #   #           #   #     #       # #   # # #
 ### # # ##### # #   # ### ##### # ######### ######### # ### # # ### ####### ### ### ####    ##### ### ###   ##### # # # #####   ##### # ### ##### ###     ### #    ##   ##### # ### #     ### ### # # #
   # # #       # #     # #   #   #       # # #   #     #     #     #     # #   #   #       #   #   # #     #   #   #   # #   #   # #   # #       # # #       # #     #       # # #   #       #       # #
 ### # ######### # # ### # # # #####   # # # # # # ##### ######### ##### # ### # ############# # # # ##### ### # ### ### # # # ### # ### ##### ### # # ##### # ##### #   ### # # # ######### ###########
     #       #     # #     #   #   #   #   # # #   #   #       #   #   #     # #         #   #   # #     #   # # #         #   # #   #     #     # # #   #   #       # # # # # # #         #     #     #
 ##    # ##### ##### # #####   # # #   ##### # ##### # ####### # ### # #   ### ##### ### # # ##### #     ### # # ######    ##### # ####### # ### # # ### # ########### # # # ### ######### ### ### ### #
       #   #   #     #           # #         #       # #   # # #     #       #   # #   #   #   # # #     #   #     #       #     #   #   # # #   #     #   #       #   #   #   # #   #     # # #   #   #
##    ## # # ###   #########   ### ############# ##### # # # # ########### # ### # ### # ##### # # # # ### ####### # ####### ### ### # # # # # ####### ##### # # ### # ### ###     # # ##### # # ### ###
 #     # # # #       #     #         #   #     # #   #   # # #         #   #   # #   # # #   # # # # #   #       # # #     #   #   #   # # # #       #   # # # # #   #     # #     # #   #     # # #   #
 ##### # # # # ### # # ### ######### # # # ### ### # ### # # ######### # ### # # ### # ### # # # # # ### ####### # # # ### # # ######### # # ##### # ### # # # ### ######### ##    # # # ####### # ### #
     # # #   # #   # # # #   #     #   # #   #     #   # # #     #   # #   # # #   # # #   # #   # #   #     #   #   # #   # #   #     # # #   #   #   # # # #         #       #   # # #             # #
 ##### # ##### # ### # # ### # # ####### # # ######### ### ### # # ### ### # ##### # # # ### ##### ####### # # ####### # # # ### # ### # # # ### ### ### # # ######### #    ## # ### # ############# # #
 #   # # #     # #     #     # #       # # #     #         #   #   #   #   #         #     #     # #       # # #     # # # # # #   #   #   # #   #   #   #     #   #             # # #       #     # # #
 # # # # # ##### ############# ### ### # ### ### ########### ####### ############### ######### # # # # ##### # # #   ### ### # ##### # ##### # ####### ######### # # ########    # # ### ##### ### ### #
   # # # # # #         #   #   # # #   #   #   #       # #     #     #             #   #     # #     # #   # #         #   # #   #   #   #   # #   #   #       # # # #   #       # # #   #     # # #   #
 ### # ### # # ####### # # # ### # ####### ########### # # ### # ####### ######### ##### ### ########### # ########### # # # ### # ####### ### # # # ##### ### # # ### # # ####### # ##### ##### # # # #
   #       #         #   #       #                     #     #           #               #               #             # #       #           #   #         #     #     #   #               #         # #
########################################################################################################################################################################################################