############################################################          ##################################################################################################################################
   # #         #               #     #       #     #                           # #             #     #                         #     #   #       #           #   #       #             #             # #
## # # ####### # ### ######### # # # ##### # # ### # #######          ###### # # # ####### ### # ### # ######### ############# # ### # # ####### # ##### ### ### # # ### # ########### ##          # # #
 # #   #     #   #   # #       # # #   #   #   # # #       #               # # #         #   #   #   # #       # #               #     #         # #   #   #   #   #   # # #         #             # # #
 # # ### ### ### # ###           # ### # ####### # # # ### #           ### # # ############# ##### ### ####### # # ##### ####################### # ### ### ### ### ### # # # #          #          # # #
 # #   #   #                     # #     #               # #           #   # #               #   #   #     #   # # #   # #           #   #   #   #   # #   #     #   # # # #                       #   #
 # ##### # ###                  ## #                     # #           # ### ################# # ### ##### # ### ### # # # ######### # # # # # ##### # # ####### ### # # # ###          #          ### #
   #   # #                                                 #           #     #             #   #   # #   #   #   #   # # #   #   #   # #   #   #   # # #     #   #   # #   #                         # #
 ### # #####                                             ###           ########### ### # ### # ##### # # ### # # # ### ##### # ### ### ######### # # # ##### ### ##### # ### #          #          # # #
   # #                                                     #             #       # #   # #   #       # #     # # # # #       #   # # # #   #     # # #     #   #       # #   #                     # # #
## # ########                                            # # ##### ### # # ##### ### ##### ################# # ### # ########### # # # # # # # ##### # ####### ######### # ###                     # # #
 # # #                                                   # # #         #           # #     #               # #     #       #     # # #   # # #     # # #     #     #   # #                 #     # # # #
 # # # # ###                                             # # ###########           # # ########### ####### ##### ### ####### # ### # ##### # ##### # # # ### # ### # ### #####          ## # ##### # # #
 #   # # #                                               # # #     #   #           # #   #         #           # #           # #   #   #   #     # #   # # # #   # #         #             #     # # # #
 ####### # ##            #                    #          # # # ### # # #           # ### ### #######           # ##### ####### # ### # # ######### ### # # # ##### ### #########           ####### ### #
 #       # #             #                         #     # # #   #   #             #   #     #   #             #     #     #   #   # #   #         #   # #       #   # #                   #     # #   #
 # # ##### ##            #           ### # # ##### ####### # ### #######           # # ####### # #             ##### #######          ## # # ##### # ### # ##### ### ### ########          # ### # # ###
   #     #               #   #   # # #                     #     #                 # #       # #               #     #   #             # # # # #   #   # # #   #   #         #               # # # #   #
 ####### #####           # ##### # # #           #######################          ## ##### # ### #            ## ##### # # #           # ### # # ##### # ### # ### ########### ##          ### # # ### #
   #   # #   #           # #   # # # #                 #           #               # #   # #   # #                     #   #           #     #   #   # #     #   #     #     #                 # #     #
## # # # ### #          ## # # # # # #           ##### # ######### # ###           # ### # ### ###            ##############          ###### ##### # # ######### ##### # ### ###           ### # # #####
 # # # #   #               # #   # # #               #           # # #   # #   #   #     #   # #               #     # #               #   # #   # # # #     # #   #     # #               #   # #   # #
 # # ##### ###           ### ####### ##          ################# # # ### ### # ########### # # #                     # # #           # # ### # # # # ### # # ### ####### ######          ##### ### # #
   #     # #   # #     #             #                           # #   #   #   #   #         # #                         #               #     #   # #     # #   #     #           #     #       # #   #
 ##### ### # ### ### # ##          ###           ############### # ### # ### ##### # ######### ###                     #####          ############## ####### ### ##### ########### ### ########### ### #
 #   #   # #   #   # #               #           #             # # #   #   #               # #     #   #               #                   #       #       #     #   #           #   #               # #
 # # ### # # # ### # ####          # #           # ########### # # # ##### # #          ## # ####### ##### #           # ##### # ########### ##### ##### # ##### ### ########### ### ####### ### ### # #
   #   # # # #     #   #           # #       #   # #     #   #   #   #     #               #       #       #           #   #   #   #       # #     #   # #     #   #       #   #   #   #   # #   #   # #
######          ###### ##          ####### ### # # ### # # # ######### #######           ### ############# #           ### # ### # # ##### # # ### # # # ######### ### ### # ##### # ### # # # # ##### #
                   #   #               #   #   # #   # #   # #                           #     #   #       #             # # #   #       #   #   #   # #           #   #   #     # # #   # # # # #   # #
 #####           # # ###           # ### ### ### ### # ##### # # ##          #          ## ### # # # #######          ## # # # ############# ### ##### ########### # ### ### # # # # # ### ### ### # # #
   #             #   #             #     # # # # #   #   # # # #             #                   #   #     #             # # #     #       # #   #   # # #       #   #   #   # # # # #   #   #     # # #
## ###           # ### ##          ####### # # # # ##### # # #####           #                   ##### ####### ######### # # ####### ##### # # ##### # # # ##### ##### ####### ### ##### ### # ##### # #
 #               # #   #   #   #   #       #   # # #     # # #   #                                           #     #   # # #     #   #   # # # #     # # #   # # #         #   #   #     #   # #   #   #
 #####          #### ### ##### ### ##### ##### # # # ##### # # # #                                       # # ##### # # ### ##### # ##### # ### # ##### # ### # # # ####### # # # ### ##### ### # #######
 #                 # #   #     #         #   # # #   #     #   # #                   #                     # #   #   #   #           #   #     #     # #   # #   # #     #   # #     # #   #   #       #
 # ###           # # # # # ########### ### # # # ##### ### ##### #                   ##                  ### ### ####### #           # ######### ### # # # # # ### # ### ##### ####### # ### ### ##### #
   #             # # # # #         # # #   # # #       # #     #                                           #     #     # #           #       #   # # # # # # #   # # # # #   #         # # #   #   #   #
 ##### ####### # # # # ########### # # # ### # ####### # ##### ####                 ##                   ####### # ### # ##          ### # ### ### # # # ### ### ### # # # # ##### ##### # ### # ### # #
 #   #       #   #   #     #   #   #   #   #   #     # #   #   #     #               #                           # #   #               # # #   #   #     #               # #     # #     # #   # #   # #
 # # # ### # ######### # # # # # ##### ### ##### ### # ### # ##### ##### #           ##                  ########### # ####          # ### # ### ####### # ##          ### ##### ### ##### # ### # ### #
 # # # #   #   #   #   # # # # #     #   #   #     # #   # #   #   #     #           #                               # #               #   # #   #     # # #               #   #   #             # #   #
 # # ### ##### # # # ### # ### ##### ####### ##### # ### # ### # # # #####          ## ##                # ########### # ##          ### # # ### # ### # # #           ####### ### ##          ### # ###
   #     #     # #     # #         #       #       #   # #   # # # #       #           #             # #   #       #   #                 # #     # #   # # #                 #                     #   #
########## ##### ####### ######### ##### # ########### # # # # # ### ##### #          ## # ##### # # # ### #          ####           ########### # ### ### #           ##### #######           ####### #
   #     # # #   #     #   #   # #     # # #           # # #   #   #   #   #           # #       # # #   # #           #   #     # # #         # #   #     #               #     # #                   #
 #           # ### ### ### # # # ##### # ### ##########          # ### # ###           # ########### ### # #          ## ####### # # # ##          # #######           ######### # #               #####
 #               # # #     # #     #   #   # #     #               #   #                     #         # #               #             #             # #                         #                     #
 ##                # ####### ####### ##### # # ### # ##          ### #######          ###### ##### ### # ###          #### #          ###          ### # ####          ########### ##              ### #
                   #         #           # # #   # # #           # #                       #       # # #   #             # #                       #   #   #   #   #         #   # #                 # #
 #                 ##### ##### ######### # # ### # # #           # #########          #### ######### # ### #          ## ###           ##          ### ### # ##### # ####### # ### #               # # #
 #                       #     #     #   # #     #   #                   #             #   #   #     # # #                             #           #     # # #     # #   #   #     # #             # # #
##                 ##### # ##### ### ##### ######### ##          ##### # # #           # ### # # ### # # ###                          ###          # ##### # # # ### # ### ### ##### # ##          # # #
                   #   # # #   # # # #   # #         #               # # # #     # #   #     #   #   # #   #                                         #     # # # #   # #   #   #     # #           # # #
 ##                ### # # # ### # # # # # # #########           ##          ### # # ############# # # # # # # ###                    ###          # # ##### # ### ### # ### ### ##### #           # # #
                     #   # #   # # # # #   #   #   #             #               # #       #       # # # # # #                                       #   #   #     #   #   #     #   # # # #   # #   # #
## # #             # # ### ### # # # # ### ### # # ##          # #           ### # # ### # # ######### # ### #####                     # ### # # # ##### # ######### # ### ######### # # # # ### # #####
   # #               #   #     # #   # #   # #   #             # #           # # # # #   # #   #     # #   #   #             #       # #     # # #   #   #         # #   #         # # # # # #   #     #
 ### ##          ######### #           # ### ########          # ##          # # # # # ### ### # ### # ### ### # #          #          # ##### # ### # ########### ##### ######### # # # # # ######### #
   #             #     #   #           #         #             #             # # # # # #     # # # #   #   # #   #                     # #   # #   # # #     #   # #     #   #   # #   # # # #         #
## ###           # ### # ###          ######## ### #           # #           # # # # # ####### # # ##### # # #####                     ### # ### ### # # ### # # # # ### # # # # # # ### # # # ####### #
   #             # #   # # #             #     #   #           # #             # # # # #   #   #     #   # #                               # #   #   #   #   # # #   # # # #   # # # # # # #   #   #   #
 ### ##          # # ### # #           # # ##                  # #           ### # ### # # # ####### # ###                  #          ##### # ### # ##### ### # ##### # # ##### # # # # # ####### # ###
 #   #           #                     # #                       #               #   # # # #       #   # #                             #     #   # #   # #   # #   #   #   #     # #   # #         #   #
 # ####          #                    ######                   ##### ##### # ####### # # # ### ### ##### #                             # ####### # ### # ### # # ### # ##### ##### ##### ############# #
 #       #   # #                                       # #   #       #     # #   #           #   #       #                             # #     # # #     #   # #     #       #   #   #   #     #       #
 ### ##### ### ##                      ######          # ### # ######### ### # ##            ### ##### ###                             # # ### # # ##### # ### ############### # ### # ### ### # #######
     #   #   #                         # #             # #   #   #       #   # #               #   #   #             # #               #   # #   #   #   #   # #   #           #   # #     #   # #     #
 ##### # ### # ##            # # ### # # # ##          # # ##### # ####### ### #             ##### ##### ##          # # ##### ####### # ### ####### ####### # # # # ############# # ### ### # # ##### #
   #   #   #   #               #   # #   #             # #   #   #   #   #   # #                 #       #           # #     # #     # # #         #         # # #   # #     #   # #   # #   # #   #   #
#### ##### #####             ##### ##### ###           # # # # ##### # # ### # #             ### ##########          # ### # # # # # # # ######### ############# ##### # # ### # # ### # # ### ### # # #
   # #   #                   #   #     # #             # # # #     # # #       #               #                     #   # #   # # # # #           #     #     # #       # #   #   #   # #   #   #   # #
 # # # # ########            # # ##### # # ##### # ##### ### ##### # # ####### ##            ### # ######### # # # ##### # ####### # # ########### # ### # ### # # ####### # ####### ####### ### ##### #
 # # # #       #               #     #   # #   # #     #     #   # # #   #   #                 # #     #   # #   # # #   #         # #   #       # # # # # # #   # # #   # # #       #       #       # #
 # # # ####### #           ######### ##### # # # # ### ##### # # # # ### # # ###             # ### ### # # # ##### # # ############# ### # ### ### # # # # # ##### # # # # # ##### ##### # ######### # #
 #   # #     # # #   # #   #       #     #   #   # #       # # # # #     # # # #           #     # #   # # #   #   #   #           # # # # # # #   # # #   #   #   # # #   #     #     # # #       # # #
 ### # # ### # # # ### ### # ##### ##### ######### # ### ### ### # ####### # # # # # # # ####### ### ### # ### # ### ##### ### ##### # # # # # # ### # ##### ### ### # ######### ##### # # # ##### ### #
 #   # #   # # # #       # #     # #   #       #   #   # #   #   # #       # #   # #   # #     # #   # # #     #   # #   #   #         # # # # #   # #     #   # #   #   #     # #   # # # #   # # #   #
 ##### ##### # ########### ##### # ### ##### ### ##### ### ### # # # ####### ##### ##### # # ### # ### # ######### # # # ############### # # # ### # # ##### # # # # ### # ### # # # # # ##### # # # ###
             #                   #         #         #         # #         #             # #       #               #   #                 #   #       #       #     #   #     #     #   #         #     #
########################################################################################################################################################################################################