########################################################################################################################################################################################################
   #       # #     #     # #                     #         #   #         #                 #     #         #                   #         #                   #       #           #           #   #     #
## ##### # # # # # ### # # # ######### ######### # ####### ### # ####### # ############### # ### # ### ### ### ### ########### ### # ### # ####### ######### # ##### ### ####### ##### ####### # # # # #
 # #   # # #   # #     # #   #   #   #         #   # #   #   # #       #   #       #   #   # # #     # # #     #   #       #     # # #   #   #   #       # # #     #     #       #   #         #   # # #
 # # # # # ### # ####### ### # # # # ######### ##### # # ### # ####### ##### ### # # # # ### # ####### # ####### ### ##### ##### ### # ####### # ####### # # ##### ####### ####### # # ############# # #
   # #   #   # # #     #   #   #   #       #   #     # #     #       #     # #   # # # #   # #     #   #   #       # #   #   # #     #         # #       # #       #     # #   #   # # #         #   # #
 ### ####### ### # ### ### ########### ##### ### ### # ######### ######### ### ### # # ### # # ### # ### # # ##### # # ##### # ################# # ####### ######### # ### # # # # # ### ####### # #####
 #         #     # #     #         #   #   #   # # # # #       #     #   #   # #     #   #   # #   # # # #   #   # # #     # #     #           #   #       #     # # #   #   # # # #     # #     #     #
 # ##### # ####### ############### ##### # ### # # # # # ##### # ### # # ### # ######### ##### # ### # # ##### # # # ### # # ### ### ##### ######### ##### # # # # # ### ##### ### ####### # ##### ### #
 # #   # # #     #             #   #     #     #   #   # #   # # # #   #   # #   #     #     # # #   # #   #   # # # #   # #   # #   #   #         # #   #   # # #     #     #     # #       #   # #   #
 ### # ### # ##### ##### ##### # ### ############# ##### # # # # # ####### # # # # ######### # # # ### ### # ### ### # # ##### # # ### ########### # # # ##### # ##### # ### ####### # ####### # # # # #
   # #   # # #     #   #   # # # #   #   #       #     # # # # #   #     #   # # #   #       # # #   #   # # # #   #   # #     #     #     #     #   # #     # #   #   # # # #       #   #   # #   # # #
## # ### # # # ##### ##### # # # ### # # # # ### ##### # ### # ##### ### # ##### # # # ####### # ### ### # # # ### ##### # ######### # ### # ### ##### ##### # ### ##### # # # ##### ### # # # ##### # #
 #   # #   # #       #     #   #   #   # # # #   #   #   #   # #     #   #       # # # #       # # #   #   #     #       # #         #   #   #     #   #   # #   # #   # #   #     # #   # #   # #   # #
 ##### ##### ####### # ##### ##### ##### # # ##### # ##### ### # ##### ### ####### # # # # ##### # ### ######### ######### ##### ####### ##### ##### ##### # ### # # # # # ### ### # # ##### ### # ### #
           #         # #   # #   #       # # #   # #     #     #   #   #   #     # # # # # #         #       #   # #     #     # #   #       #     # #     #     # # #   # #   # # # #     #     # #   #
 ######### # ######### # ### ### ######### # # # # # ### # ##### # # ##### ##### # # # ### # ############# ### ### # ### # ### # # # ####### ##### # # ### ####### # ##### ### # # ####### ##### # ### #
   #     #       #   # #         #         #   #   # #   # #     # #     # #   # # # # #   #       #       #   #   #   # # #   #   #   # #       # # #   # #   #   # #   #   #   # #   #   #   # #   # #
## ### ######### # # # # ####### # ################# ### # ####### ##### ### # # # # # # # ######### ##### # ### # ### # ### ######### # # ####### # ### ### # # ### ### ### ### # # # # ### # # ### ###
 #     #       # # # # #   #   # #           #     #   # #         #   #   # # #   # # # # #   #     #     # #   #   # #     #       # #   #       #   #     #   #   #     #   # # # #   # # # #   #   #
 ##### # ##### ### # # ##### # ####### ##### ##### ### ############# # ### # # ### # # # # # # # ########### ##### # # ####### ##### # ##### ##### ### ####### ### ### ####### ### # ##### # # ### ### #
   #   #     # #   #   #     #     #   #   #     #   #     #         # # # # #   # #     # # # #     #             # # #     # #     # #     #   #   #       #     #         #     # #       # #   #   #
 # # ####### # # ### ### ####### # # ### # ##### # ##### # # ######### # # # ### ######### # # ### # # ############### # # # # # ##### # ##### # ### ####### ##### ####### # # ##### # ####### # ### ###
 #       #   #   #   #   #     # # # #   # #   #   #     # #     #       # # # #       # # # #   # #         #         # # #   # #     #   #   #   #     #   #     #     # #   #     #     #   # # #   #
######## # ### ####### ##### # # ### # ### # # ##### ##### ##### # ####### # # ####### # # # ### # ########### ######### # ####### ##### # # ##### ### ### ### ##### ### ####### ######### # # # # ### #
       # # #   #     #       # #   # # # #   #       #   # #   # # #   #   # #       # #   #   # # # #       # # #       #             # # #     #   # #   #       # # #   #   #   #   #   # # #     # #
 ##### ### # ### ### # ########### # # # # ########### # # # # # # ### # ### # ### ### # ##### # # # # ##### # # # ################### ### ##### ### ### ########### # ### # # ### # # # ### ### ##### #
 #         # #   # #   #           # # #   #         # # #   #   #     #     # # #     # #     # #   #   # #   #   #             #   #     #   # #       #   #   #   #   #   #   # # # #   #     #     #
 ########### # ### ##### ######### # # # ### ####### # # ############# ####### # ######### ##### ####### # ##### ### ### ####### # # ##### ### # ######### # # # # ### ####### # # # ### ######### #####
         #   #       # #       #   # # #   # # #   # # # #             #     # #   #       #   #   #   # #     # #     # #       # # #   #     #     #     #   #   #         # # # # #   #       #     #
 ####### ########### # ####### ##### # # ### # # # # # # ####### ##### ### # # # # # # ##### ##### # # # ### ### # ##### ######### # # # ########### # ################# ### # ### # # ### ##### ##### #
 #     #     #   #   #     # #       # # #   #   # #   #       # #   #   # # #   # # # #   #       # # # #   #   # #     #         #   #       #     # #         #     #   # #     # # #   #   # #     #
 # ### ##### # # # ### # # # ######### ### ####### ########### # # # ### # # ##### # # ### # ####### # # # ### ##### ### # ##### ############# # ### # ### ### # # ### ### # ####### # # ### ### # ### #
 # #   #   #   #   #   # #   #   #   #     #         # #   #   # # # #     #   #   # #   #   #       #   #   # #     #   #   #   #     #       # #   #   # #   #   #       #   #     # # #   #   #   # #
 ### # # # ######### ### ### # # # # ######### ##### # # # # ##### # ########### ####### # ######### ##### # # # # ######### ##### ### ### ##### # ##### # # ################# ### # # # # ### ### # ###
     # # # #         #   #     # # # #   #     #   # #   # #       #             #       #       #   #     #   # #         #       # #   # #     #   #   # #   #         #   #   # # # # # #   #   #   #
###### # # ### ####### ######### # # # # # ####### # ##### ####################### ############# # ### ################### ######### ### # ##### # ### ### ### # ### # ### # ### # ### # # # ######### #
   #   # #   #       #   #     #   #   # # #       #   #         #         #       #         #   # #   #     #               #         # #     # # #   #     # # #   # #   #     #     # #             #
 # # ### ### ####### ### # ### ######### # # # ####### # ####### # ### ### # ####### ### ### # ### ### ### # ### ########### ##### ### # ##### # ### ######### # # ### # ########### ### ####### ##### #
 # # #   #         # # #     #   # #   #   # #         #   #     # # #   #   #       # # #   #   #   #     #     #       # #   #   # # #     #   #   #         # # # # # #         #   #       # #   # #
 ### ### ######### # # # ####### # # # ##### ########### # ####### # ### ########### # # ####### ### ############# ##### # ### # ### # ##### ##### ##### ####### # # # # ####### # ### ####### ### # ###
   #   #       #   #   # #       #   #       #         # # #     # #   #   #       # # #       #   # #   #       #   #       #   #     # #   #     #     #     # # # # #         # #       # # #   #   #
## ### # ##### # ##### ### ####### ############### ### ### # ### # ### ### # ##### # # ####### ### # # # # ### # ### ############# ##### # ### ##### ##### # ### # # # ########### ####### # # # ##### #
     # #   #   #     # #   #     #     #         # # # #   #   #   #     #   #     # #   #     #   # # # # #   # #   #           # #     #     #     #     #     # #     #       #     #   # # #     # #
 ### # ### # ####### # # ### # ####### # ### ### # # # # # ### ##### ######### ##### ### # # ### ### # ### # ### # # # ####### ### # # ######### ####### ######### ####### ### ####### # ### # ### ### #
 #   #   # # #     # # #   # # #       #   # # #   # # # # #   #   #       # # #   #   # # # #   #   # #   # #     # # # #     #   # #           #     # #   #     #       # #   #     #   # #   # #   #
 ####### ### # # # # ##### # ### ########### # ##### # # ### ### # ##### # # # # # ### # # ### ##### # # ### ######### # # ##### ### ### ######### ### ### # # # ### ####### ### # ####### # ### # # ###
       # #   # # # #       #     #       #   #   #     #       # #       #   # # #   # # #   #       # # # #           # # #     #     #   #       # # #   #   # #   #         #   #     # #   #   #   #
 ##### # # ##### # ######### ##### ##### # ### ### ########### # ############# # ##### # ### ######### # # ############# # # ##### ####### # ####### # # ##### ### ### ####### ##### ### # # ######### #
 #   #   #     # # #       # #   #   #   # #   #   #         #   #             #     #     # #       # # #           #   # # #     #     # #         # # #   # #   #   #     # #       # # #     #     #
 # ########### # # ####### # # # # # ### # ### # ####### ### ##### ############# ### ##### # # # ### # # # ### ##### # # # # # ##### ### # # ######### # # # ### ### ### # ### # ##### # # # ### # ### #
 #             # #   #     # # # # #   #   #   # #       #       #   #   #       # #       #   #   #   # # # #     #   # # # # #     #   #   #         # # #   #     #   #     # #   # # # # #   # #   #
 ### ##### ##### ### # # ### # # ##### ##### # # # # ########### ### # ### ####### ############### ##### # # ##### ####### # # # ##### ####### ######### # ### ####### ######### # # # # # ### # # #####
   # #     #   #   #   # #   # #     # #     # # # #       #         # #   #                 #     #     #   #   #       #   # #   # #       # #     #   # # #     #   #   # #   # # # #       # # #   #
## # # ##### ### # ####### ### ##### # ##### ### ######### ########### # ### ####### ####### # ### # ##### ### # ### ### ######### # ####### # # # # # # # # # ### # ### # # # ### # ### ####### # # # #
 # # #     #     # #     #     #   #   #     #   #       #     #       # #   #       #     # # #   # #     #   #   #   #         # # #     # # # # # # # # # # #   # #   # #   # # #   # #   #   #   # #
 # ####### ### ### # ### ####### # ##### ##### ### ##### # ### # ### ### # ### ####### ##### # # ### ####### ##### ### ### ##### # # # # ### # # # ### # # # # ##### # # # ### # # ### ### # # ####### #
   #     #   # #   #   #   #     #     #     #     #     # #   # # #   # # #   #   #   #   # # #   #   #   # #     #     # #   #   #   #   #   # #     #   # #   #   # # #   #   # #   #   # # #     # #
 ### ### ### # # ##### ### # ######### # ### ####### ####### ### # ### # ### ### # # # # # # # ####### # # # # ########### # # ##### ##### ##### ########### ### # ##### ### ##### # ### ### ### ### # #
     #       # #         #           #     #                 #       #       #   #   #   #   #           #   #             # #           #                     #         #         #     #       #     #
########################################################################################################################################################################################################