#####          #########################################################################################################################################################################################
 #             #   #   #         #   #         #     #     #         #     #               #                 #       #     #     #   #         # #           #       #       #                   #     #
 # #           # # # # # # ##### # # ### ##### ##          # ##### ### # # ### # ########### # ############# # ##### # # # # ### ### # ##### # # # ### ##### # ##### # # ### # ##### ########### # ### #
   #             #   # # # #   #   # #   #   #             #     #     # #     # #           #       #     # #     #   # #   #       #     # # #   #   #     #   # # # # # # #   #   #   #   # # # #   #
#####          ####### ### # ####### # ### # ###           ##### ####### ### ##### ################# ##### # ### ####### ##### ######### ### # ##### ### ##### # # # ### # # ##### ### # # # # # # #####
                 # #   #   #       # # # # #                 #   # #     #   #     #         #     #     # # #   #       #     # #       #   #       # #   # # # #   #   #     #   #   #   # #   #     #
 # #           # # # ### ### ##### # # # # ######          ### ### # ##### ### ##### ####### # ### ##### # # ##### ########### # # ####### ########### ### # # # ### # ####### # ### ####### # ##### # #
 # #           # #   #   # # #   #   # #   #   #               #   # #   #   # #   #     # # #   #   #   # #     # #         # #     #     #   #         # #   #   # # #   #   #       #   # # #   # # #
 # ##          # ### ### # # # ####### # ### # #           ##### ### # ##### # ### # ### # # ### ### # ### ##### # # ####### ### ##### # ### # ### # ### # # ##### # # # # # ### ##### # # # # # # ### #
 #             #   #   # # # #         # #   #             #   #   # #       # #   #   # #     # # # # #       # # #       #   # #     # #   #   # # #   # # #     # # # # #   # #   #   # # # # #   # #
 ### # # # # # ### ### # # # # ##### ##### ######          # # ### # ######### # ##### # ##### # # # # ####### # # ####### ### # # ### ### ##### # # ##### ### ##### # # # ### ### # ### ### # # ### # #
   # #   #   #   # #     #   # #     #   # #               # #   # #       #   #     # #     # #   # #       #     #         #   #   # #   #   # # #     #   #   # # # # #   # #   # # # #   #   #   # #
## # ########### # ####### ### # ##### # # # ##### ##### # # ### # ####          # # # ##### # # ### ####### ####### ############### ### ##### # # ##### ### # # # # # # ### # # ### # # # ####### ### #
 # #         #   #             #       #   # #   # #     # # #   #               # # # # #   # # #   #     #         #   #         # #         # # #   #   # # # #   #   #   #   # # #   #   #   #   # #
 # ######### # ###           ############# # # # # # ### # # ### # ###           # # # # # ### # # # # ### ########### # # ####### # # ######### # # # # ### # # ### ##### ####### # ####### # # ### # #
 # #   #     # #             #           #   # #   # #   # #   # # #             # # # # # #   # # #   #       #   #   # # #     # #     #   #   #   # #   # # #   # #   # #             #   # #   # # #
 # ### # ### # ###          ## ######### ##### ##### # ### ### # # #             # ### # # ##### # ##### ##### # # ### # # # ### # ####### # # ### ##### # # ##### # # # # ############# # ### # ### # #
 #     #   # #                           #   #   #             # #               #     # # #     # #     #   #   #   # # # # #   # #   #   #   #   #   # # #       #   # #             #   #   #   #   #
 ##### ### #######                     ### ##### #          #### # ##            # ##### # # ##### ##### # # ####### # # # # # ### # # # ####### ### # ### ############# # ########### ########### ### #
     # # #       #                       #   #   #           #   # #             #     # #       # #   # # # #     #   # # # #   #   #   # #   # #   #   # #   #     #   # #     #               #   # #
## ### # ##### # #          #          # # # # ###           # #####             ##### # ######### # # ### # # # # # ##### # ### ######### # # # # ##### # # # # ### # ### # # ###           ### ### # #
   #   # #     # #                     # # #   #             #                     #   # #         # # #   # # # # # #     # # # #   #       #   #     #   # # # #   #   # # # #               # #   # #
 ### ### # ##### #                     # # ##### #          #########           ## # ### # ##### ### # # ### ### ### # ##### # # # ### ############### ####          ### # # # # ##          ### # ### #
   # #   #   # # #   #   # #             #   #   #             #                   #     #   #   #   #   # #   #     # # #   # # #       #     #     # #               # #   # # #           #   #     #
 # # # # ### # # ##### ### ##          ####### ###           # ### ##            ######### # ##### ####### ### # ##### # # # # # ######### ### # ### # # ##          # # # ##### #           # ### #####
 #   # # #   #       # #   #               #   #             #     #                     # # #     #         # #   # # # # # # #       #   # #   #   # # #             # # #     #           # #   #   #
 ##### # # ########### # ##            ### # #####          ###### # #          ######## ### # ######### ##### ### # # # # # # #####          #### ### # #           ### # # #####           # # ### # #
 #     # #           # #               #   #         # #   #   #   # #                 #   #               #   #     # # # # #   #                     #               # # # #                 #     # #
 ### # ############# # ####          ### ### ####### # # # # # ##### #              ###### ##### ########### # ####### # #                     # ##########          # # # # # # ##          ######### #
   # #     #       #   #               # # #     #   # # #   # #                                             # #       #                       # #                   # # # # # #   # #     #       #   #
## # ### # ### ### #######             # # ##### # ### # ##### # #                   ###           ######### ### #########                     ### #######           # # ### # ### # # ### # ### # # ###
   #   # #   # #       #                 # #     # #   # # #   # #                   # #             #     # #   #   #                             # #   #             #   # #   #   #   # #   # # # # #
 ####### ### # # ##### # ##           #### # #####           ### #                   # #          ## # ##### # ### # # # #                     ##### # # ########### ##### # ### ####### # ### # ### # #
     #   #   # # #     # #                   #   #             # #                     #             #       # #   # # # #                           # # #           #   #   #   #   #   # # # #     # #
#### # ### ##### ### ### #            ###### # # #           # # #                  ## #           ### ####### # ##### # #                        ## # # # ##### ##### # ##### ##### # ### # # ####### #
 #   # #   #   #   #   # #                 # #               #   #                   # #           #   #     # #     # # #                         # # # #   #   #     #     #     # # # # # #   #     #
 # ### ### # # ### ### # ##           #### # ##              ### ##                  # #           ##### ### # # ### # # #          #              # # # ### ##### ##### ######### # # # # # ### # ### #
   #     #   #     #   #               #   #                   # #               # #   #           #     #   # # # #   # #                         # # #     #     # #   #     #   # #   # #     #   # #
 ####### ########### ### ##            # ######              # ###           ### # #####           # ##### ### # # ##### ####### ### ###          ## # ### ### ##### # ### ### # ### # ### # ######### #
       # #         # #   #             #                     #                   #   #   #   #     # #   # #   #   # #   #     #   # #               # #   #   # #   #       # # # #   #   # #         #
         # ### ### # # ###           ##########              ######          ##### # # ####### ##### # # # # ##### # # ### ### ### # # #           ### ##### ### # # ######### # # # ### ### # # ##### #
         # #   #   #   #     # #     #   #                   # #             #     # #             # # # # # # #   # #   # # #     # #             #   #     #     #     #     # # # # # #   # # #   # #
                 ####### ##### # ##### ### ###                   ##          # # ################### # ### # # # ### ### # # ####### ###          ## # # ##### ######### # ##### # # # # ### # ### # ###
                   #   #   #   # #   #     # #                               # #       #       #     #       # #   #   #   #         # # #     #     # #   # # #     #   #     # #   # #   # # #   #   #
                 # # # ### ### #                                 #           ####### # # ##### # ############# ### ### ######### ### # # # # ######### ### # # # # # # # ##### # # ### ### # # # ##### #
                   # #   #   #                       #           # #   #         #   # # #     #         #       #           #   # #   # # #     #   # #   #   # # # # #   #   # #     # # #   #   #   #
                 ### # ##### ###                  #####          # ############# # ##### ##### ##### ### ####### ########### # ### ### # ### ### # #           ### # # ###          ## # # # ##### # # #
                               #                                 # #       # #   #     #     #     #   #       #   #     #   #   #     #   #   #   #               # #   #           #   # # #     # # #
                 #           # #                   ####          # ### ### # # ### ### ##### ##### ######### # # ### # ### ##### # ####### # ########          ### ##### #           ##### ### ##### ###
                 #             #                     #           # #   #   # # #     #   # # #   #         # # #     #   #     # #   #   # # #     #             # #   #                 #         #   #
 #               #           ###                  ## #           # # ##### # # ##### # # # # # ########### ### # ####### ##### # ### ### # ### ### #           # ### # ###          #### ######### ### #
 #                           #                     #             # # #     #       # # #   # #                         #       # # # #   #                       #   #                 #     #   # #   #
###          ######          ###                  #### ### ####### # ### ######### ### # ### ### #######           ############# # # # #####                   # # ####              ####### # # ### # #
             #               #                       #   #     #   #   # #     # #   # # #   #   #     #           #   #     #   #     #                       # # #                       #   #   # # #
 ##          # ##            # ### # ######### ### ##### ##### # ##### # # ### # ### # # # ### ##### #             # # # # ### # ####### #                     ### ###              #### ######### # # #
             # #             #   #   # #   #   # #       #   #   #     # # #   #       # # # #   #   #             # #   #   # #       # #                         #                   #     #   #   # #
 #           # ##                    # # # # ### ########### ##### ##### # # ### ######### # # # # # ##           ## ####### #           #             # ##### ##### ##          ##### ##### # # ##### #
 #           # #                     #   #   #               #         #   # #   #         #   # # # #               #     #             #               #   # #                 #   # #   # # #     # #
 #           # #                     # ################### # ######### ##### ##### ############# # # #            ######## ####                        ### # # #                 # # # # # # # ##### # #
 #             #                       #         #         # #     #   #   # #   # #     #       # # #             #     # #                             # # #                     # #             #   #
 # ### #########                     #           # ######### # ### # ### ### # # # # ### # ####### ###             # ### # # #                         # # # ###                 ### ####          #####
 #     #       #                                   #       #   # # # #     #   #   #   #   #                       #   #   # #                           # #                 #     #               #   #
 ######### # # #                     #          #### ########### # # # ### ######### # ################          # ### ### # ##                      ##                      ##### # # ##          # # #
         # # # # # # # #                           #             #   #   #     # #   # #       #   #             #   # #   # #                     # #                             # # #           # # #
######## ### ### # # # ###           #          ## # ########### ##### ### ### # # ### # ##### # # # # # # ##### ### # # ### #                     # ##                      ######### #           # # #
       #   #     # # # # #                         #     #     #       #   #   # #   #   #   #   #   # # #     #   #   # #   #                     #                                   #             # #
 ##### ### ##### # # # # ### ##### ###          ######## # ### ######### ### ### ### ##### # ######### # ### # ### ##### # ####### # ####          ###                       ##### #####           ### #
 # #     #     #               #   #                 #   #   #           #       # # # #   #         # #     #   #   #   # #                       # #                           # #   #             # #
 # # ######### ####          ### # # #          ## ### ##### ####### ########### # # # # # ######### # ####### ##### # ### #          ###### # # ### #                       ### # # # ##          ### #
 #     #       #             #   # # #             #   #   # #   #   #         #   #   # # #   #   #   #   #   #     # # # #           #   # # #     #                   # # #   # # #   # # #   #     #
 ##### # ####### #           # ### # # # # ##### ### ### # # # # # ### ####### ### ### # ### # # # ##### ### ### ##### # # #           # # # # ##### ##                # ### # ### # ### # # ### # ### #
     # # #     # #             #   # # # # #       # #   # #   # #   # #     # # # # # #     # # #     #     #   #       #               #   # #   # #                 #     #   # # # # # #   #   #   #
 ### ### # ### # ##          ### ### # # # # ##### # # ######### ##### # ### # # # # # ####### ####### # ##### #############          ######## # # # # # ###           ######### # # # # # # # #########
 #   #   #   #   #             #     # # # # #   #   #   #       #     # #   # #     #     # #       # #     #                                 # # # # # #               #     # # #   # # # #         #
 # # # ##### #####           # ####### # ### ### ####### # ### ### ##### # ### ########### # ####### # # ###################           ####### # # ### # # ##          # # # ### # ### # # ### ##### # #
 # # #       #                   #     # #   #     #     # # # #   #     #   #         #   #     #   #   #     #   #     #               #     # #     # # #           #   #       #   # #   # #   # # #
 # # ######### ####          ### # ### # # ### ### ### ### # # # ### ####### ####### # # ##### # # ####### # ### # # # ### #          ## ####### ####### ###           ########### # ### ### ### # ### #
 # # #       #     #       #     #   # #   #   # #   # #   #   #   # #     #     # # # #   #   # #   #   # #     #   #     #   # #   # #   #   #       #   #       # #         #   # #     # #   #     #
 # ### ##### ##### ##### ### ####### # ####### # ### # # ######### ### ### ### # # # ##### # ### ### # # # ################# # # ### # ### # # ####### ### ####### # # ####### ##### # ##### # ####### #
 #         #           #             #         #       #               #       #   #         #     #   #                     # #         #   #           #         #         #       #         #       #
########################################################################################################################################################################################################