########################################################################################################################################################################################################
   #       #   #         #       #         #                     #         #             #           #   #     #   #               #           #                   #       #             #           # #
## # # ### # # # ##### # # ##### # # ##### ######### ##### ##### ### # ### ############# # # ####### ### # ### # # # # ####### ##### ### ### ### ########### # ##### ### # # ####### ### # ####### # # #
 # # #   #   # #     # #   #   # # #     # #       # #   # #   #   # #   #       #     #   # #     #   # #   # # #   #     #   #     # # #   #   #     # #   # #     #   # # #     #   # # #       # # #
 # ##### ##### ##### # ##### ### # ##### # # ##### # # # # # # ### ##### ####### # ### # ### # ### ### # ### # # ####### # ### # ##### # ##### ### ### # # # ### ##### ### # ### # ### ### # ####### # #
 #   #   #   #     # # #     #   #   #   # #   #   # # # # # # #         #     #   #   # #   #   #   # #   # #   #     # #   # # #     # #   # #   #     # # #   #     #   # #   # #   #   #       #   #
 ### # ##### ##### ### ### ### ##### # ### ### # ##### # # # # ########### ### ##### ##### ####### # # # ### ##### ### ##### ### # ### # # # # # ####### # # # ### ######### # ### # # # ######### ### #
   #   #         #   #   # #   #     #   # #   # #     #   # #   # #   #   #       #   #   #   #   # # # #       # #       # #   #   # # # #   #       # # # #   #     #   # #   # # # # #       # #   #
## ####### ##### ### ### # # ########### # # ### # ##### ### ### # # # # # ########### # ### # # # ### # # ####### ####### # # ### # # # # ####### ### ### # ### ##### # # # ### ### ### # ####### ### #
   #       #   #   #     # #             #   # # #     # #   #   #   #   #   #       #   #   #   # #   #   #     #     # #   # #   # # # #   #   # #   #   #   #     # # # #   #   #     #       #   # #
 ### # ##### # ### ####### ################### # # ### # # ### ### ######### # ### ####### ######### ####### ### # ### # ### # ##### ### ### # # ### ### # ####### ### # # ### ### ############# ### ###
     # #     #     #           #           #     #   # # #   # # # #       #   # #       #       #   #       # # # # # #     #       #     #   #     #   # #       #   # #     #   #   #       #   #   #
 ##### # ############### ##### # ### ##### # ####### # ##### # # # # ##### ##### ####### # ##### # ### ####### # # # # ### ### ####### ############# # ##### ####### # # ####### # # # # ##### ### ### #
 # #   # #     #       #     # #   #   #   #     #   #       # #   #   #   #   #       #       # # #     #   #   #   #   # #   #   #     #         # #   #   # #     # #       # # # # #     #   #   # #
 # # ### ### # # ##### ##### # ##### # # ####### ####### ##### # ### ### # ### # ##### ######### # # ### # ### ##### ### ### ### # # ##### # ####### ### # ### # ##### ####### # # # # ##### ### # # # #
   # # #   # #   #       #   #     # # #       # #     # #     # #   #   #     #   #   #     #   # # #   #   #     #   #     #   # #       #   #     # #   #   #   #   #       # #   #       #     # # #
#### # ### # # ######### # ####### ### ####### # # ### ### ##### # ### ####### ##### # # ### # # # # # ### # ##### ########### ### # ##### ### # ##### ##### # ### ##### ##### # ########### ####### # #
     #       # #   #   #   #     #   #       # # #   # #   #   # # # # #     #       # # #     # # # # #   #     #   #         # # # #   # #   # #   #       #   #   #   #   # # #       #   #     # # #
 ####### ##### # # # # ##### ####### # ##### # # ### # # ##### # # # # # ############# # # ####### ### ##### ####### # ######### # # # # ### # # # # # ######### ### # ### # # # # # ##### ### ### # # #
       # #   # # # # # #   #     #   #   #   # # #   # #     # # #   # #             # # # #     #   # #   #   #   #   #     #     # # #     # # # #   #       #   #   #   # #   # #     # # # #   # # #
 ##### ### # ### # # # # # # ### # ##### # ### # # ### ##### # # ### # # ########### # # ### ### ### # # # # # # # ##### ### # ##### # ######### # ####### ####### ##### ### ########### # # # ### ### #
 #   # #   #     #   # # #   # # #     # #   # # # # #   #   # # #   # #   #       # # #       #   # # # # # #   #       #   # #     #   #       #         #       #     #     #       #   # #   # #   #
 # # # # ############# # ##### # ##### ##### # # # # ### # ### # # ### ### # ##### # # ######### # # # # # ####### ####### ### ######### # ############# ### ##### # ######### # ##### # ### ### # # # #
 # # #   #       #   # # #     #     #       # #   #   #   #   # #   #   # #   #   #   #     #   # # # # #   #   #     #     #       #   # #   #         #   #   # #         #   #   # #   #   # #   # #
 # # ##### ##### # # # # # ####### ########### ##### # ##### # # # ##### # ##### # ##### ### # ### # # # ### # # # ### ############# # ### # ### ##### ### ### # # ######### ##### # # ### ### # ##### #
 # # #   # #   #   # # #   #     #       #     #     # #     # # # #     #     # # #   # # #   #   # #     # # # #   #             # #     #     #   #   # # # #   #     # #     # # # # # #   #     # #
## # # # # # ####### # ### # ### ##### # # ##### ### ### ### # # ### ######### # # # ### # # ####### # ##### # # ### ####### ### ### ##### ####### # ### # # # ##### ### # ##### # ### # # # # ##### ###
   #   #   #       #   #   #   # #   # # # #     #   #   # # # #     #     #   # # #   # #   #     # # #   #   #   # #     #   # #   #   #         #   # # # #     #   #       # #     #     # #   #   #
 ########### # ############### # # # # # # ####### ### ### # ######### # ### ### # # # # ##### ### # ### # ####### ### ### ### # # ### # ############# ### # ##### ### ##### ### # ########### ### ### #
   #       # #   #           # #   #   # # #       #   #   #         # #   #     # # # #       # # #   # #       #       # # # # # #   #   #         # #   #   #   #   #     #   #       #   #   #   # #
 # # ##### # ### # # ####### # ### ####### # ##### # ### # ##### ### # ### ####### ### ######### # ### # ####### ######### # # # # ### ### # ####### # # ### ### ### ### ##### ######### # # ### # ### #
 # # #   # #   #   # #     #   #   #       #   #   # # # #     # # # # #       # #           #   #     # #     # #   #   # #   # # #   #   #     #   #   #           #   #     #     #   # #       #   #
## # # # # ### ##### ### # ##### ### ####### # ##### # # # ##### # # ### ##### # ########### # # ####### ##### # # # # # # ##### # # ##### ##### ### # ############# ##### ##### ##### ########### # # #
   # # #     #     #   # #         #     #   #   #   #   #     # #       #   # #       #     # #     #   #     #   #   #   #   # # #     #     #   # # #         #   #     #       #   #       #   # # #
 ##### # ######### ### ################# ####### # ########### # ######### ### # ####### ##### ##### # ### ################# # # # ##### ##### ### # ### ####### ##### ########### # ### ##### ##### ###
 #     #   #       #   #         #     #   #     #             #         # #   #       #       # #   #   # #     #   #       #   #       #   #     #     # #   #   #   #           #   #     #     #   #
 # ######### ##### # ### ####### # ### ### # ######### ########### ##### # # ##### ### ######### # ##### # # ### # # # ### ### ############# ############# # # ### # ##### # ######### ### # ##### ### #
 #           #   # # #   #     #   # #     #           #         # # #   #       #   #   #       # #     # #   # # # #   #   # #             #   #     #     #   # #     # #   #     #   # # #   #     #
 ############# # # # # ### ######### ####### ########### ####### # # # ######### # ### # ### # # # ### ### ### # # # ### ### # # ####### ##### # # # # # ##### ### # ### ##### # ### ### # # # ####### #
 #             # # #   # #           #           #     #   # #   #   #     #   # # #   #   # # # #   #   #   # #   #     # # # #   #   #     # #   # # # # #   #   #   #     # # # #   # # # #     #   #
 # ############# ### ### # ####### # # ######### ### ##### # # ########### # # # # # ##### ### # ### ### # ### ########### # ##### ### ##### # ##### # # # # # # ### ####### # # # ### # ### # # # # ###
         #     #   #   #   #     # # # #   #   #     #     #   #           # # # # #   # # #   #   #   # #     #         # #   #   #     #   #     # # # # # # #   # #       # # #   # # #   # # # # # #
######## ### # ### ### # ### ### # ### # # # # ##### # ##### ### ########### # # ##### # # # ### ##### # # ##### ####### # ### # ### ##### ####### # # # # # ##### ### ####### # # ### # # ### # ### # #
       #     # #   # # #   #   # #   #   # # #   #   #   # # #   #   #       # # #   # # # # #   #   #   # #     #     #   #   #   #     # #       # # #   #       #   #       # # #   #   #   # #   # #
 ##### ##### ### ### # ### ### # ### ##### # ### ####### # # ### # # # # ##### # # # # # # # ##### # ##### # ##### ####### # ##### ##### # # ####### ##### ######### ####### ### # # ####### ### # ### #
     #     # #   # #   # #     # # # #     # # # #       # #     # # # #     # #   #   #   #   #   #       # #             #       #   # #   # #   #       #             #   #   # # #     # # # #     #
 ### ##### # # ### # ### ####### # # # ##### # # # ####### ####### ### ##### ########### ##### # ########### ### ################### # # ##### # # ######### ########### # # # ### # # ### # # # ##### #
 #   #   # # # #   #   #       #   # # #     # # # #   #     #   #   #   # #     #       #     # # #           # #           #       # # #     # #     #     #   #       # # #     #     # #   #       #
 # ##### # ### # # ### ### ####### # # # ##### # # # ### ### # # # # ### # ##### # ####### ##### # # ######### # ##### ##### # ####### # # # ### ### # ####### # # ####### ####### ####### ### #########
 #     #       # #       # #     # # # # #     #   #     # #   #   #           # # #       #     #       #     #       #     # #   #   #   #     #   # #       #   #   #           #     #   #   #     #
 ##### ################# # # # # # # # # # ### ##### ##### ################### # # # ####### ############# ############# ##### # ### ####### ##### ### # ########### ### ########### ### ### ### ##### #
   #   #         #   # # #   # # # #   # # #   #   # #       #     #     #     # # #     #   #     #   #   #         # #   #   #           # #     #   #     #   #   #   #     #     #       #   #     #
#### # # ####### # # # # ### # ### ##### # # ### # # ### ##### # ### ### # ##### # ##### # ### ### # # # ### ####### # ### # # ########### ### ##### ### ### # # ### # ### ##### ########### # ### #####
     # # #   #   # # # #   # #   # #   # # # #   #   #   #     #   # # # # #   #   #   # # #   # #   # # #   #     # #     # # #     #     #   #   #   #   # # #     #     #   #   #       # # #       #
 ####### ### # ### # # ### ##### # # # # # # # ####### # # ####### # # # # ### ##### # # # ### # ##### # # ####### # ##### # ### ### ##### # ### # ### # ### # ### ##### ### # # # # ##### ### # ##### #
   #   #     #     # #   #     #     # # # # # #       # # # #     #   # #     #     #   #   # #         # #       #     #   #   # #     # # #   # #   # #   # #   #   # #   # # #       # #   # #     #
## # # ##### ####### ### ##### ######### # # # # ######### # # ####### # ##### # ########### # ######### # # ########### ##### ### ##### # # # ### # ### # ### ##### # # # ### # ##### ### # ### # #####
   # #     # #   #   #   #   #   #       # # # #             # #   #   # #     #           # #   #   #   # # #         #     #   # #     #   # #   # #   # # #       # # #   # # #   # #   # #   #     #
 ### ### ### # # # ### # ### ### # ######### # ####### ####### # # # ### # ##### ##### ### # ### # # ##### # # ####### # ### ### # # ########### # # ##### # # ####### # ### # ### # ### # # ######### #
   # # #   # # # # #   #   #   #   #         #   #   #   #   # # #   #   #     # #   #   # #   #   #         # # #     # # #       #     # #     # # #     #     #     #   # #     #     # #     #     #
 # # # ### # ### # # # ### # # ##### ### ### ### # # ##### # # # ##### ####### ### # ##### ### # ############# # # ##### # ############# # # # ##### # ##### ##### ####### # ##### ############# # ### #
 # # #   #   #   # # # # #   #   #   #   # #   # # #       #   # #   #     #       # #       # #   #     #     # # #   #     #   #   #   #   #     #   #   # #     #     # # #     #           #   # # #
 # # ### ##### ### # # # ### ##### ### ### ### # # ####### ##### ### ##### ######### # ##### # ### ### ### ##### # # ####### # # # # # ### ####### ##### # # # ### # # ### # ##### # ####### ####### # #
 # #   #       #   # # #     #     #   #       # # #   #   #   #         #   #     #   #   # # #   #   #   # #     #           # # # # #     #         # #   #   # # #     # #   # # #     #         # #
## ### # ##### # ### # ### ### ##### ######### # # # # # ### # ### ######### # # # ##### ### # # ### ### ### # ################# # # # ####### ####### # ####### # # ####### # # ### # ############# # #
     #   #   # # #   #   #   #     # #       # # # # # #   # #   # #   #   # # # # #     #   # # #     # #   #   #             # # #   #     #     #   #     #   # #   #   #   #     #       #       # #
 ### ##### ### # # ##### ### ##### # # ##### # # # ### ### # ### # # # # # # ### # ### ### ### # ##### # # ##### # ########### ### ##### ### ##### # ##### ### ### ### # # ############# # ### ### ### #
 #   #   #     # # #     # #     # # # #   # # # #   #   # # # #   # #   #   #   #     #     # #     # # #       #     #         # #       #       # #   # #   #     # # #               # #   # # #   #
 ### ### # ##### ### ##### ##### # # # # # # # # # # ### # # # ##### ######### ######### ##### ##### # # # ##### # ### ######### # ####### ######### # # ### ######### # ################# # ### # # ###
   #   # # #   #   # #           # #     # # # # # #   #   # #     #   #                 # #   #     # # # #   # #   #         # #       #     #       #   # #       # #       #           #   # # # # #
 # ### # # ### ### # ######### ### ####### # ### # ### # ### ### # ### # ######### ####### # ####### # # # # # # ### ######### # # ### ### ### ########### # # ##### # ####### # ############# # # # # #
 # #     #     # # #         #   #   #   # #     # #   #   #     #   # # #       #     #   # #     #   # # # # #   #     #   # # #   #   #   #         #     # #   # # #       # #   #     #   #   #   #
 # ########### # # # ####### ####### # # # ##### ### ############### # # # ##### ##### # # # # ### ### # ### # ### ####### # # # ####### ### ######### ####### # # # # # ####### # # # ### # ######### #
 #           # # # # #   # # #   #   # # # #   #     #   #     #     # # #     # #       # # # #   #   #     # #   #       # # #         # # #   #     #     #   # #   # #     #   # # # #   #       # #
 ######### # # # # # # # # # # # # ### # ### # ####### # # ### # ##### ####### # ######### # # ### ### ##### # # ### ####### # ########### # # ### ##### ### ##### ##### ##### ##### # # # ### ##### # #
   #       # #   # #   #   #   #   #   #     #     #   # # # # # #   # #     # #       # # # #   #   # #   # # # #   # #     # # #     #     #   #       # #     #   #   #         # # # # #   # #   # #
## # ####### ### # # ##### ######### ############# # ### # # # # # # # # ### # ####### # # # ### ### # # # ### # # # # # ##### # # # ### ####### ######### ### ##### # ### # ####### # # # # ### # ### #
 # #       # #   # # #   #         #   #       # # # # # #   # #   # # # # #   #   #   #   #     #   # # # #   # # # # #     # # # # #   #       #           #   #   #   # # #       # #   # #   #   # #
 # ####### ### ### ### # ############# ### ### # # # # # ### # ##### # # # ##### # # ############# ##### # # ### ### # ##### # # # # # ####### # # ######### ### # ##### # ### ####### ##### # # ### # #
         #       #     #                   #     #     #     #       #           # #                     #   #       #         #   #           #   #           #         #           #         #   #   #
########################################################################################################################################################################################################