##################################################################################################################################################################################   ###################
         #   #         #       # #                   #         #       #       #               #                 #         #         #       #                 #                       #               #
######## # #   ###   # # # ### # # ##########    ### ### ##### #    ## # ####   ## # ######### ####### ##### ### # ####### # ### ### ##### # #   ####### ####### ######### #######   # ##### ######### #
     #   #           #   # #     # # #   #         #   #     # #         #       # # #       #       # #     #   # #   #   # #   #   #     #         #   #         #       #     #   # #   #   #   #   #
   # # ### #   ###   ##### # ##### # # # # ##      ### ### # ###    ########     ### # # ########### ### ###   ### # # # ### # ### ### #######   ##### ### ######### ##### # ### ##### # # ### # ### ###
   # # #   #     #   #   # # #     #   # # #   #   # #   # #   # #   #         #   # # #           # #   #     # #   # #     # #   #     #   #         # # #     #   #   # #   #   #     #     #     # #
   # # # ##### # # #   # # # # ##### ### # # #####    ## ##### # ### ##### ### ### # # ######### ### # ### #   # ##### ####### # ####### # ### ######### # # ##### ### #   ### ### ############# ##### #
 # # # #     # # #     # # # #   # #   # # # #   #           #     #     #   #   #   # # #     # #   # #           #   #   #   # #     # # #   #         # # #     #   #     #   #       #     #     # #
 # # # #############   ##### ### # ### # # # # # #    ####   ##### ##### #####   ##### # # # # # # ### ####    ##### ### # # ### ### # # # # ##### ##### # # # #######     # ### ####### ### # ##### # #
 # # # # #                 #   # #     # # #   # #               #     #           # # #   # # #   #           #   # #   # #   #     #   # #       #     #   # #         #     # #     #   # #     #   #
 # ###    #     ######## ####### ####### # ##### #    #### ##### ##### #####    ## # # ##### # #####   ### ##### # # ### # ### #   ####### ######### ####### # ### ###     ##### #     ### ##### # ### #
 #                     #   #             # #     #     #   #   #     #     #     #   #   #   #     #     #       #       #   #         #     #     # #       #   #   #     #     #         #     # #   #
 ######    #    ###### # # ############### ### #######   ### # ##### # #####   # ### ### # ####### #   # ###########   ### #####   ### ##### # # ### # ######### ### # #   # #####    ###### ####### ###
 #     # #   # #     # # # #             #   # #         # # #       # #       #   #   # # #     # # # # #     # #     #   #     #   #   #   # # #   # #       #   #   #   #   #   #         #   #   # #
 ##    # ##### # ### #     ############# ### # # #####   # # ######### # ###   ### ### # # # ### ### # # ### # # # # ### ### ### ### ### # ### # # ### # #     ### ########    # ### # #####   # # ### #
       #       #   # #     #   #             #   # #       #   #       #   #       #   # # # # #       #   # # #   #   #   # #     # # # #   # #   #   # #       # #           # #   #     #   #       #
## # # ##### # ### #        ## ### ############### # ### ##### # ######### # # ######### # # # #    ###### # # # ##### ### # ####### # # ### # ##### ######   ## # # #####     # ##### ### #   ####### #
   #   #     #   # #         #     #       #       # # #     # #     #   # # # #     #   # # # #     #   #     #     # # # #   #       # #       # #         # # # #   #       # #   # # #     #   # # #
 ##### # ######### #   ##   ###    # ##### ### ##### # ### ### ####### # # # # # ### # ### # # ####### # ###   ####### # # ### # ####### # ##    # ########### # # ### #     ###   # # # # ##### # # # #
     # #           # # #   #       # #   #   #       #   #     #       #   # # #   #   #   # #   #   # # #     #       # #   # #   #     # #     #   #         # #     #       #   # #   #   #   # # # #
#### ### ########### # ### # ####### # # ### # ####### # ####### ########### ##### ##### # # # ### # # # # ### # ##   ## ### # ### # ##### # ##### ###   # ### # ####### ##### #   # ### ##### ### # # #
   # # # #     #     #     # #     #   #   # #   #     #   #   #     #             #   # # #   #   #   # #   #   #           #   # #     #   #     #     #   # # #     # #   # #   #   # #       # # # #
 ### # # # # ### ### ##### ### ### ####### # ### ##### ### # # #####   ############# ### # ### # ####### ### # ########### ### # # ##### # ##### ### #   ##    # # # # # # ### ####### ### ####### # # #
 #   # # # # #   #       # #   #         # # # #       # #   #                 # #       #   # #   #       #   #         #   # # #   # # #     #     #   #     # # # # # # #         # #   #   #   #   #
 # ##### # # # ####### ### # ### ######### # # ######### ##   ######   ####### # # ######### # ### ####### #####   ##### ##### ##### # # #     ####### # #    ## #   # # # # #   ### # # ### # # #######
 #   # # # # #       # #       #   #       # #           #         #         # # #     #   # # # #       #   #         #   #   #   #   # #             #         #   #   #   #   #   #     # # #       #
 ### # # ### ####### ### ##    ### # ####### # #   ##### #     ### ##### ### # # ##### # # # # # ####### ### # #   # # ### # ### # ### # #   ############    # ###   ##### ### # # ####### # # ####### #
   #   #           #             #     #     #     #   #   # #   #       #   # #     # # # #       # #   # # #   #   # # # #   # #   # #         #   #       # # #   #   #   # # # #   #     # #       #
 ##################################### # ######### # # ##### ### ######### ### # ###   # # ####### # # ### # ### # ### # # ##    # ### ######### # # # ##   ## # # # # # ### # # # # # ######### ##### #
         # #           #   #     #   # # #         # #       # #   # #     #   #       # #   #       # #   #     # # #   #       #     #   #   #   # #     #   # # # # # #   # # # # #           #   # #
 ### ### # ##### ########### ### # # ### # ####### # ######### ### # # ##### ### ###   # ### # ####### ### ####### # #   ###    ######## # # # # ### ####### ### # # # ### ### # #    ############## # #
     #   # #   # #         # #   # #     #       # #   #         # # #   #   # # #       # # #   #       #     #   #     # #             #   # #   # #   #   #     # #   # # # # #     #       #   # # #
#    ##### # # # # ####### # ###   # ####### ### # ### ### ##### # # ### # ### # # ####### # ##### #   # ### # ###   #   # ################### ### # # # # ### ##### ### # # # # ##    # ##### # # # # #
           # # # # # #     #   #   # #     # # # # #   #   #     # #   # #   #   #   # #   #       #   # #   #   #   #         #         #     # # #   #   #   #   #   #     # #   # #       #   # #   #
 ########### # ### # #     # # #   # # ### # # # # # ### # ####### # # # ### ####### # # # ######### # # # ##### #   #####   # # ##### ### ##### # ######### ##### ### # ##### ### #####   # ##### # ###
     #       # #   #       # # # # # # #   #   # # #   # # #     # # #   # #   #   #     #     #     # # #     #     #   #   #         #   # #     #                 # # #   # # # #               #   #
#### # ####### # ####### # ### # # ### # ##### # ##### # ### ### # ### ### ### # # #    ## ##### ####### ### # ######### # # ##   ###### ### # ##################### # ### # # # # # ######   ######## #
   # # #           #   #       # #     #   # # #   #   #   # #   #   #   #   #   #         #   # #     #   # #   #       # #             # #   #         #       #   #   # #   # # # #   #         #   #
 ### #    ##    ## # # ######### # ####### # # ### # ### # # # # ### ### ### ######### ### # # # # ### ### # ### # ####### ####### ####### # ##   ## ### # ##### ####### # ##### # # ### # ### ##### ###
   # #                   #       # #     # #   # #   #   #   # # # # # #         #     #   # #   #   #     #   # # #             #                   # # # #   #     #   # #         #   #   # #     # #
 # # #     ### # ##   ## ### ##### ##### # # ### ##### ####### # # # # ### ##### # ### # ### ##### # ########### # # ########### ###   #######    #### # # # # ##### # # # # ####### # #   # # # ##### #
 #   #   # #   #       #   #   #         # #     #     #   #   #     # #   #   # # #   # #   #     #         #   #     #     #     #         #   #     #   # #   #     # # # #     # #     # #   #     #
 ##### ### # ######### ### ### #   ####### ##### # ##### # # ###     # # ### # ### # ### # ##### ########### # # ####### ### ##### #####    ######## ##### # ### ####### # ### ### ### #   # ##### #####
   #     # # #       #   # # #             #   # #     # # # # #     #   #   #     # # # #     #   #       # # # #       # #     # #                 #     # #   #   # # #   # # #   # # #   #         #
## # ##### # # ##### ##### # ### ### ####### # # ##### # ### # ### # # ### ######### # # ##### ### ### ### # # ###   ##### ##### # # ##### ### ####### ##### # ### # # # ### # # ##   ## # ########### #
 # # #     #   # #   #     #   #     #     # #     # # # #   #     # #   # #       # #   #     #   #   #   # #   #   #   #   # # # # # #   # #     #   #   # # #   # #     #   #       #     #     #   #
 # ### ######### # ###    ## # ######### ### #   # # # # # ######### ##### ### ##### # ### ##### ### ### ### # # ### ### # # # # ### # # ### ##### # ### ### # # ### ##### ##### #     ##### # ###   # #
 #     # #       # #         #   #       #   #   # #   # #     #     #     #   #     #   #     # #   # # # # # #   #     # # # #     #   # #     # # # #   # #   #     # # #     #   #     #   # #   # #
 ####### # # ##### ###     ### ### #    ## ### ### # ### ##### # ##### ##### # # ####   ##   # # ### # # # # #     ##### # # # ####### ### # #   #   # # # # ######### # # ####### ####### ##### #   # #
 #         #     #     # #   #   # #         # #   #     # #   #   #   #     # # #             #     #       #         # # #         # #     #       #   # #     #   # #         #     #   #         # #
 # ############# ####### ### ### # # # ####### # ####### # # # ### # ### ### # # # ##   ##   ############    ##    ##### # #########    ####   ###   ##### ##### # # # ######### # ##    ######### # # #
   #   #       #         # # # #   #       #   # #     #   # #   #       #   # # # # #                           # #     #   # #                 #   #         #   # #   #     #         #         # # #
 ### # # ##### # ####### # # # ############# ### # # # ##### ### ####    # ##### # # # # ################# ##### # # ####### # # ####   ####   # # ### # ####### ### ### # ### #         # # ### ##### #
     # # #       #   #   # #     #     #     #   # # #       #   #       #   #   # #   #                 #       # # #       #   #   # #   #   #       #   #   # #   # #   #   #     #   # #   # #     #
###### # ######### # #   # ##### # # ### ### # ##### ######### ############# # ### ### ################# ######### # ###     # ### # # # # ############### # # ### ### ##### ##### # # ####### ### #####
   #   #     #     # #     #   #   # #   #   #   #   #   #   # #           # #   #   #               #   # #       #   #     # #   #   # #     #   #     # # #     #       # #       # #   #   #   #   #
 # # ####### ####### ### ### # ##### # ### ##### # ### # # # # # # ####### # ### ### ################# ### # ### # ### # # # # ####### # ##### # # # ### ### ####### ##### # # ####### # # # ### ### # #
 #   #     #   #   #     #   # #     #   # #     #     #   # # # # # #   #     #   # #     #     #   # #     # # #   # # # # # #     # #   # # # # #   #     #       #   # # #   #   # # #   #   #   # #
 ######### ### # # ####### ### # ####### ### ############### # ### # # # ##### ### # # ### # ### # # # # ##### # ##### # # # # # ### ##### # # # # ### ####### # ##### # ### ##### # # # ##### ### ### #
             #   #           #         #                     #     #   #         #     #     #     #   #       #         #   #   #         #     #     #       #       #           #   #           #   #
########################################################################################################################################################################################################