###########################   ##########################################################################################################################################################################
   #       #           #             #   #       #   #     #               #               #       #   #   #     #   #         #             #       #                 #           #       #         # #
## ### ### ### ##### ### ##    ##### # ### ### # # # ### # ##### ### ##### # ######### ##### ### # # # # # # # # # # ##### ### # ####### ### ### ### ########### ##### # ######### # ### # # ##### # # #
 #     # #   #     #   # #         # #     # # #   #   # #     # #   #     # #   #   #       #   #   # #   # # #   #     # #   #   #   # #     #   #     #   #   #   #   #       # #   # # #   #   #   #
 ####### ### # ####### # ###    ## # ##### # # ####### # ##### # # ######### # ### # ######### ####### #   ### ######### ### ##### # # # ##### ### ##### # # # # # # ######### # # ##### # ### # ##### #
       #     # #     #     #     # # #   #       # #   #   # # # #       #   #     #     #   #     #   #       #       #   #       # # #   #       #   # # #   # # # #         # # #   # #   # #   #   #
 ### ### ####### ### ##### # # ### # # # ####    # # ##### # # ######### # ####   ## ### # # ##    ### # ####### ##### ### ######### # ### ######### # # # ####### # # ####    ### # # # ### # ### #####
 # #   # #       # #   # # # #   # #             # #       # # #       # #   #       #   # #         # #   # #       #   #           #   #     #     # # #   #     # # #       #   # # #   # #   #     #
 # ### # # ####### ### # # # ### # ##   ########## ######### # # ##    # ### # # # ### ### # ####### # ### # # ##### ################### # #   # ### ### # # # ##### # # #     # ### # ### # ######### #
 #   #   # # #         #   #   # # #     #         #   #     #   #     #   #   # #   #     # #     # #   # # # # #   #           #     # # #   # # #   # # #     #   # # #     # #   # #   #         # #
 ### ##### # # ######### ####### # ### ### ##### # ### # ### ##### # ### # ##### # # ###   # # ### # ### # # # # # ### ##### ###     # # # # # # # ### # # ##### # ### ######### # # # # ####   #### # #
           # # #   #     #     # #   #   # #     #   # # # #     #   #   #     # # # # #   # #   #   # # # #   # #   #     #   #     # # # # # #     #   # #   # #   #   #   #   # # # #   #       # # #
############ # ### # ####### # # ### ### # # ####### # # # ### ### ####### ##### ### # # # ##### ##### # # # ### ### ### ##### ##    ### # # # ##### ####### # ##### # # # # # ##### # # # ###    ## # #
   #         #   # # #       #   # # #   # #       #   #   # #     #       #     #   #     #     #         # #   #   #   #     #   #     #   #   # # # #     #     # # #   # #       # # #   #     # # #
 # # ####### ### # # # ######### # # # ### ####### ######    ####### # ##### ##### ### ##### ### ########### ### # ###     ##### ############### # # # # # # ##### # # ##### ######### # ### # ### # # #
 # # #     #   # #   #     # #     # # #   #     #   #             # #   #   #       #   #   # # #       # #     #   #       #   #       #       #   # # # # #   #   #     #   #     # #   # # # # # # #
## # # # # ### # # ##### # # # ##### # # ####### ### # #    ###### ### # # ### ##### ##### ### # # ##### # ### ##### #    ## # ##### ### # ####### ### # # ### # ######### # # # # ### ### # # # # # # #
   # # # #   #   #     # # #   #   # # #       #   #   #   #     #   # #   # #   # #     # #     #   # # #     #   # #   # #   #     # #   #     # #     #   # #   #   #   # # # #   # #   # #   # #   #
 ### # # ### ######### ### ##### # # # ####### ### ##### # # # # ### # ##### ### # ##### # ######### # # ####### # # ### # ##### ##### ##### ##### # ####### # ### # # ##### # #   # # # ### ### # ### #
     # #   #   #   #   #   #   # #   # #     #         # # # # #   # # #     #       #   # #       # # #   #     #   #   #       #   #       #     #   # #   # # #   # #     # #   # # #   #   # #     #
 ######### ### ### # ### # # # # ##### # # ########### # ### # ### # # ### ### ####### # # # ###   # # ### # ####### # ##### # ### # ### ### # ####### # # ### # ##### # #######   # # ####### # #######
 #       #   #     # #   # # #   # #     #           #     # #   # # #   #       #     # # #   #   # #   # # #   #   #     # # #   #   #   # # #     #   #   #   #     #   #     # # #       # #     # #
 ##### # # # ##### # #   ### ##### # ########### ### #   # # ### ### ### ### ##### ##### # ### #   # ### # # ### # ####### ### # # ### ##### # # ### # ##### ### # ##### # # ##### # ####### # ##### # #
       # # # #     #       # #         #     # # # # #   #   # #   #   #   #   #   # #   #     #   #     # #   #     #   #     # # #     #   # #   #   #   #     # # #   # # #     #       #   #   #   #
######## ### ### #####   # # # ####### # ### # # # # ### ##    ### ### ### ##### ### # #####   ### # ##### # #    ## ### ####### # ##### # # # ######### # ####### # # ### # # ### ##### ####### # ### #
   #   #   #   # #   #     # # #     #   #     # #     #         #   # #   #     # #   #         #   #     # #             #   # # #   #   # # #         #     #   #   # #   # #     #   #       #   # #
 # # # ### ### ### # # #####     ### ##### ##### ##### ####   ## # ### ### # ##### # ##### #   # ##### ##### ##    ####### # ### # # # ##### # # ############# # ### ### ####### ### # ### ##### ##### #
 #   #   #   #     #   #   #       #   # #   #   #   #     # #   #   #   # #     #   #     #   # #   # # #   #   # #   #   #   # #   #     # #   #           #   # #       #   #   # # #   #   #     # #
 ##### ##### # ######### # #     ##### # ### # ### # ##### # # ####    # # ##### ### ### ### ### # # # # # ### ##### # # ##### # ######### ######### ############# ####### # # ### # # # ### ####### # #
     #   #   #     #   # # #     #   # #   # #     # #       #   #       #     #   #     #   # #   # # #     # #     # # #     # #   #   #   #       #             #     # # #     # #   #         #   #
#### ### # ######### # # # ### ### # # ### # ####### ####### ### #     ####### ### ##### # ### ##### # ##### # # ##### # ### # # # ### # ### # # ##### ##### ##    # ### # # ################# ### #####
 #   #   #   #   #   #   #   # #   #   #   #     #   #     #   # #     #     #   #   # # #   #     # # #     # #     # #   # #   # #   #   # # # #   # #   # #     #   #   #                   # # #   #
 # ### ##### # # # ######### # # ####### ####### # ### ### ##### # ### # # ##### ### # # ### ##### # # #    ## ##### # ### # ##### # ##### # # # # # # # ### ##   #### ##### ############# ##### # # # #
 # #   #   #   # # #       # # #   #       #     #     # # #   # #   #   #     # #   #     #   #   # #       # #   # # #   #   #   # #     #   # # #     #   #       # #   # #   #       # #   # # # # #
 # # ### # ##### # ### ##### # ### # ##### # ########### # # # # ### ####### # # # # ########    # # ####### # # # # # # ##### ### # ##### ##### # ####### ### ### # # ### # # ### ### ### # # # # # # #
   #     #     # # #   #     # #   # #   # #         #   # # #   #   #       # #   # #   #       # #         # # #   # # #         # #   #   #   # #   #   #     # # #   #   #       #   #   # #     # #
 ########### ### # # # # ####### ### # # # ######### # # # # #########   # ####### ### # # ##    # ########### # ##### # ########### # # ### # # # ### # ### ##### # ### # ############# ##### ####### #
 #       #   #   # # # #       #   #   # #   #     #   # #   #       #   # #     # #   # #       #   #         # #     #   #         # #       # #     #     #     # #   # #         #     #   #     # #
 # ### # # # # ### # ######### ### # ##### ### ### ##### ##### ##### #   ### ### # # ### #   # ####### ### # ### # ####### # ######### #    #### ### ######### ##### # ### ### ##### # ##### # # ### # #
 #   # # # # # #   #     #   #     # #   #     #   #   # #     #     # #     # #   # # #     #         #   # #   #   #   # #       #   #       # #   #         # #   #   #     #   # # #   # # #   # # #
 ##### # # ### ### ### # # ########### # ##   ## ### # # ##### # ##### ####### ##### # ##### ########### ### # ##### ### # ####### # ##### # ### # ### ######### # ##### ####### # # # # # # ### ### # #
 #     # #   #   # #   # #     #       #       #     #   #     # #   # #     #     #     #   #       # #   # #   # #   #     #     # # #   #     # # # #   #     # #   #       # #     # # #     #   # #
 # ##### ### ### # # ### # # # ### # ##### #####    ###### ##### # # # ### # ### ###     # ### ##### # ### ##### # ### ##### # ##### # # ##### ### # # ### # ### # # # ####### # ####### # ##### # ### #
   #     # #   # # # # # # # #     # #   #           #       #   # #       #     #       #   # #       #   #     #   #   #     #   #   #     # # #   #   #     # # # #   #     #     #   #     # #   # #
#### ##### ### # # # # # # # ######### # ####### ### ####### ### ################# ### # ### # ######### ### #####   ### ##### # # # ####### # # ### ### ####### # ##### # ########### ####### ### # # #
   #       #   # # # # # # # #         # #     #   #       #   # #   #           # #   # #   #         #     #         #     # # #   #     # #   #   # #   #   #   #   # # #     #   # #     #   # # # #
 # ####### # ### # # # # ### # ######### # ### # ######### ### # # # # # ####### # # ### # ##### ##### ######### #   # ##### ### ##### ### # # ### ### ### # # ###     # # # ### # # # # ### ### ### # #
 #   #   # # #   # # # #   # #         #   #   #         #     #   # # #   #   #   #   # #     # #             # #   # #     #   #   # #     # #   #     #   #   #       # #   #   #   # #   # #   # # #
## # # # # # # ### # # ### # ### ######### # ###    ## ############# # ### ### ####### # ##### # # ########### # ### # # # ### ### # # ######### ### ### ####### #    #### ### ######### # # # ### # # #
   # # # # # # #   # #       #   #       # # #       #             # #   #   # #       # #   # # #       #     #   # # # # #   #   # #   #       #   # # #   #   # #       #   #       # # # #   #   # #
 ####    # # # ### # ######### ### ##### ### # ##    ######### ##### ### ### # # ### # # # # # #####     ##### # ### # # ### ####### ### # ######### # # # # # ### # ####### ### ##### ### # # # ##### #
           #   #   #       #   # #     #     # #       #     #   #   # # # # # # #   # #   # # #   #         # # #   # #     #       # # # #         #   # # # # # # #       #   #   #   # #   #     # #
 ###    ######## ######### # ### ##### ### ##### ### # # ### ### # ### # # # # # # ##### ##### # # ##   #### # # # ############# ### # # # # # ####### ##### # # # # ### ##### ### # ### # ### ##### # #
   #   #         #         # #   #   #   # #     # # #   #   # # # #       # #   #     # #   #   #           # # #               #   # #   # # #     # #     # #   # #   #   # # # #     # #   #   # # #
## ########### ### ### ##### # # # # ### # # ##### # ##### # # # # ######### # ####### ### # ################# ######### ### ##### ### ####### ##### # # ### # ##### # ### # # # # ####### ##### # ### #
 #     #     # # #   # #     # #   #   # # #   #     #     #   # #   #     # #   #   #     #               #   #   #   # #   # #   #     #     #     #   #   #       #   # #   # #     #       # #     #
 #     # ### # # # # # # ##### ####### # ##### # ##### ####### # ### ### # # ##### # ### ####### ### ##### # ### # # # ### ### # ### ##### # ### ######### ########### # # ##### ##### ####### # #######
 #       # #   #   # # # #     #     # # #     #     #   # #   #   #     # #       #   # #         # #   # #     # # #   # #     #         # #   #       #   #       # #   #     #     #       #   #   #
 # # ##### ##### ### ### # ##### ### # # # ######### ### # # ##### ####### ########### # # ###   ### # # # ####### # ### # # ##### ######### # # # ##### ### ### ### # #######   # ##### ######### ### #
   #   #     #   # #   #   # #     # # # #   #   #   # # #   #   #   #   # #           # # #         # # # #     # # #   # #     # #       # # #   #   #     #   #   #   #       # #                 # #
 ##### # ### # ### ### ##### # ### # # # ### # # # ### # # ### ### ### # # # ############# ########### ### ##### # # # ### ##### # # ###   # ####### # # ##### ### ##### ### #   # # ############### # #
 #     # #   # #     #     # # #   # # #   # # # # #   # #     #   #   # #   #     #       #     #   #           #   # #       # #   #     #         # #   #     # #   #     # #   #   #           # # #
 ### ### # # # ##### ### # # # # ### # # ### # ### # # # # ##### ### ### ##### # # # ####### ### # ### ############### # ##### # ##### #   # ####### # ### ##### ### # ####### # ##### # ######### # # #
     #   # # #   #     # # #   # #   # #   # #   # # # # # #   # #   #   # #   # #   #       # # #     #       #       #   #   #   #   #   # #     # # # #           #   #     #     # #     # #   #   #
###### ### # ### # ##### # ##### # ### ### # ### # ### # ### # # # ### # # # ### ##### ####### # # ##### ##### # ########### ##### # ##### # # ### ### # #####   ##### ### ######### ####### # # ##### #
       #   #   # #   #   # #     #   #   #   #   #     # #   # #   # # # # # # # #   #     #   # #   #   #   #   # #         #       #   # # # #       #   # #   #   # #   #   #     #     #   # #   # #
 ####### ####### ### # ### # ########### ##### ####### # # ### ##### # # # # # # # # ##### ### # ##### ### ####### # ### ##### ####### # # # # ######### # # ### # # # # ##### # ### # # ### ### # ### #
     # #             # #     #         #     #         #   #         # # # #   # # #     # #   #       # #       #   # #   # #   #     # # # #     #     #   # #   # #     #       # # #     #   # #   #
#### # ############### ####### ####### ##### ############### ######### # # ### # # ##### # # ########### # ### # # ### ### # # ### ##### # # ##### # ####### # ##### ##### # #     ### ####### ### # ###
   # #       #   #   #       #     # #     # #   #         #   #     # #   #   # # #   #   #       #     # #   # # #   #   #   #   # #   # #   # # #       # #     #     #   #         #       #     # #
 ### # ####### # # # ####### ##### # # ### # # # # ####### # ### ### # ##### ### # ### ######### # # # ### # ### # ### # ####### ### # ### ### # # ####### # ### ####### # ######### ### ####### ##### #
     #     #   #   #             # # # # # #   # #     #   #       # # #     # #   #     #     # # # #     # # # # #   #             # # # #     #   #     #   # #       # #       #   # #   #   # #   #
 ####### # # ################### # # # # # ##### # ### # #######   # # # ##### ##### ### # ### # # ### ##### # # # # ####### ##### ### # # ##### ### # ####### # # ######### ##### ### # ### # ### # # #
       # # #       #             # # # #       # #   # #   #   #   # #   #   #     #   #   # # # #   # #     # # # # #     # #   # #   # #   #   #   #   #       #   #       # #   # # # #   # # #   # #
  ## # # # ####### # ##### ####### # # ####### # ### # ### # # #   # ##### ##   ## ### ##### # # ### # # ##### # # # # ### ### # ### ### ### ### # ### # ####### ### # # ##### # ### # # # ### # # ### #
     # # #   # #   # #   # #       # # #   # # # #   # # #   # #   #     #       #   # #     # #   # # #   #   # #   # # #     #   #   #   #   # # #   #       # #   # # #     #   #   # #   # #   #   #
###### ### # # # ##### # # # ####### # # # # # # ##### # ##### # # ### # # #     ### # ### # # ### # # ### # # # # ### # ######### ### # # ### # # # ######### ### ### # # # # ### ### # ### # ##### # #
     #   # #   #   #   # # # #       # # # #   #     # #       # #   # #   #   # # # #   # #   #   # # #   # #   # #   #     #   #     # #   # # # #         #     #   # # # #   #   # #   # #       # #
 ### ### # ### ### # ### ### ### ### # # # ######### # # ####### ### ########### # # ### # ##### ### ### ### ####### ### ### # # ####### ### # ### ######### ########### # # ####### ##### # ######### #
   #       #     #     #         #   #   #             #         #               #       #       #       #           #     #   #           #       #                     # #               #           #
########################################################################################################################################################################################################