###################################################################################################
   #                 #         #         #           #       #                 #                   
## # ##### ########### ##### # # # ##### ### # ##### # ##### # ############### # ########### ##### 
   #     # #           #   # #   #     #   # #     # #   #   #     #       # #   #         #   #   
 ####### # # ########### # ####### ### ### ####### # ##### # ##### # ##### # ##### ####### # # ### 
   #     #   #         # #       # # #   #   #     #       #   #   # #   #     #   # #     # #   # 
## ######### # ### ### # ####### # # ### ### # # ############# # ### # # # ##### ### # ######### # 
 #   #     # #   # #   #   #   # #   #   # # # # #       #     # #     # # #     #       #       # 
 ### # ### # ##### # ##### # ### # ### ### # # ### ##### ####### ####### ### # ######### # ########
   #   # # #       # #   # #     # #   # #   #     #   #       #     #   #   # #       #   #   #   
 # ##### # ### ####### # # # ##### # ### # ####### # # ####### ##### # ### ##### ##### ####### # # 
 #       # #   #       #   #     # #   #         # # # #     #     # #   #       #   #       #   # 
 ####### # ##### ####### ####### ### # ######### # # # # # # ### ### ### ######### # ####### # ### 
     #   # #     # #     #     #   # #   #     # # # #   # #   #     #       #     #       # # # # 
 ### ##### # ##### # ##### ### ### # ### # # ### # ### ### ######### # ##### ### ######### # # # # 
 # # #     # #     # #       # # # # #   # #   # #   # #   #       #   #   #     #     #   # # # # 
 # # # ##### ### # # # ####### # # ### ####### # ### ### ### ##### ### # # ####### ### # ### # # ##
 # #   #   #   # #   #   #   # # #   # #       #   # #   #   # #   #   # #   #   # # # # #   #   # 
 # ##### ### # # ####### # # # # ### # # # ### ### # # ### ### # ### ### ### # # # # # ### ##### # 
   #     #   # #       # # #   # #     # # #   #   #   #   # #   #     #   #   # # # #     # #   # 
## # # ### ### ##### ### # ##### # ####### # ### ##### # ### # ### ####### ##### # # ####### # ####
   # #     # # #   # #   #     #   #   #   #   #     # # #       # #     # #   #   # #   #   #     
 ######### # # # # ### ####### ##### # # ##### ##### # # ####### ### ### # # # ##### # # # # ##### 
   #     #   #   #       #   #       # #   #       # # #     #       #     # #   #     #   #     # 
## # ### ### ########### ### ######### ### ######### ### ### ####### ####### ### # ######### ##### 
 #   # #   #   #       #       #   #   #   #       #   #   #     #   #   #   #   # #     # # #   # 
 ##### ### ### # ##### ######### # # ### # # ##### ### # ####### ##### # # ### ### ### # # # # # ##
         #   # #   # #   #     # #   #   # # #     #   # #   #   #     # #   #   # #   #   #   #   
 ####### ### ##### # ### # ### # ####### # # # ### # ### # # # ### ##### ### ### # # ### ##########
       # # #       # #   #   # # #       # # #   # # #   # # #   #     #   #   # #   # # #       # 
 ##### # # ######### # ##### # # ##### ### # ### ### # ### # # # ### ##### ### # ##### # # ##### # 
     # #   #   #       #     # # #     #   #   #     #   # # # #     #   #   # #   #     #   # #   
#### # ### # ### ####### ##### # # ### ####### ########### # ######### # # # # ### # ####### # ####
     #   #   #   #       #   #   # # # #       #           #     #     #   # # # # #     #   # #   
 ####### # ### ####### ### ####### # # # ######### ############# # ######### # # # ### ### ### # # 
 #       # #   #       #       #   # # # #         #       #   #   # #       # # #   # #   # #   # 
## # ####### ### ####### ##### # # # # # # ### ### ####### # # ##### # ####### # ### # # ### # ### 
   # #       #   #       #   #   # #   # #   #   # #     #   #       # #     #     # # # #   # # # 
 ### # ####### ### ####### # ##### # ### ####### ### ### # ##### ### # # ### ##### # ### ### # # ##
 #   #   #       #   #     #     # #   #   #   #     # # #   # # #   # # #   #     #     #   #     
 ####### ### ### ### ####### ### # ### ### # # ##### # # ### # # # ### # # ### ########### ########
       #   #   #   #       # #   #   #   #   #     #   # # # # # #   # # #   # #     #             
###### ### ### ### ####### # # ##### ############# # ### # # # # # ### # ### # ### ### ####### # ##
       # # #     # #     # # #     #           # # # #   # # # # # #   #   # #   #   #   #   # #   
 ##### # # ##### # ### # # # ### ######### ### # # # # # # # # # # # ##### # ### # # ### # # # ####
   # #   # #   # # #   # # # # #         # #     # # # # #   # # # #     # # # # # #   # # # #   # 
## # ### # # # # # # ##### # # ####### # # ####### # # ### ### # ####### # # # # ### ### # # ##### 
   #     #   # # # #     # #     #     # #     #   # #   #     #     #   # #   #   #   # # #       
 ####### ##### ### # ### # ####### ##### ##### # ### ### ##### ### ### ### ### ### ### # # ########
       #     #     #   # #         #   # #   #   # # #   #   #   #         #     #   #   # #   #   