########################################################################################################################################################################################################
       #     # #   #         #     #           #         #       #     #           #   #   #         #       # #       #           #       #   #         #   #       #     #       #                   #
###### # ### # # # # ### ### # ### # ######### ##### # ### ### # # ### # # ######### # # # # ### ### # ##### # # ##### # ### ##### ### # ### # # ##### # # # ### ### # ### # ##### # ############### ###
       #   # # # #     #   #   # #   # #     #     # # #   #   # #   # # #       #   #   #   #   #   #   #   #   #   #     # #   #   # # #   #   #   # #   #   # # # # #   # #   # #       # #     #   #
 ######### # # # ####### # ##### ##### # ### ##### # ### ### ### ### ### ####### # ########### ### ##### # ####### # ####### # ##### ### # ####### # # ####### # # # # ##### # ### ####### # # # ##### #
   #       # # #   #   # #   # #   #   #   #   #   #     #   # # #   #   #     # #   # #     # #                   #     #   # #   #   #   #       # # #     #   #   #   #   # #     #     #   #     # #
## # ####### # # ### # ### # # # # # # # ##### # ### ##### ### # # ### ##### # # ### # # ### # ######          ######### # ### # # ### # ### ##### ### ##### ##### ##### # ### # ### # ############# # #
   #       # #   #   #   # # # # #   # # #     #   # # #   #   # #   #       # #     # # # # #                 #   #   # # #     # #   # #   #   #   #     # #     #   #       # #   # #     #       # #
 ######### # ##### ##### ### # # ##### # # ### ### #           # # # ######### ####### # # # #######           # # # # # # # ##### # ### ##### # ### ##### # # ##### # ##### ### ##### # ### # ##### # #
 #   #     #     #   # #     # #     # # # #     # #             # #         #   #         #       #           # #   # #   #   #               #     # #   # # #     # #   # #   #     # #   #   #   # #
 # # # ######### # # # ####### # ##### # # # ##### ##          ### # ########### # ####### ##### ###           # ##### ######### #           ####### # # ### # #           # # ### ##### # ##### # ### #
 # # # #       # #               #     # # #   #   #             # #             # #     # #     #             #     #         # #           # #   #   # # #   #           # #   # #     #   #   #   # #
 # # # # ### # # #           ##### #####           ##          # # ################# ### ### ##### #           ### ########### # #          ## # # ### # # # ###           # ### # ##### ### # ####### #
 # #   # #   # # #           # #   #                             # #                 # #   # #     #             # #       #   #             #   #     # # # #             #   # #       # # # #     # #
 # ##### # ##### #          ## # ### ####          #           ### ### ######### ##### ### # # ######          # # # ##### # ### #           ########### # # # #           # ### ######### # # # ### # #
 # #     #   #   #             #   # #             #                 #     #   # #       #   # #     # #     # # # # #   #   # # #           #         # # # #             # #     #             #   # #
 # ####### # # ###           # ### # ####          ##          ##### ####### # # # # ####### # # ### # ##### # # # # # # ##### # #           # ####### # # # ###           ### ### ####          # ### #
 #       # # #               #   # # #                             #         #   # #   #   # #     #   #   #   #   # # #     #   #             #   #     #   #             #   # #                 #   #
 # ##### # # # ##            ### # # # ##          # # # # ####### ######### ####### # # # # ########### # ### ##### # ##### # ###          #### # ####### ### #          ## ### ### ##          ### # #
 #     # # #   #               # # #   #             # # # # #   #     #     #     # # # #     # #       #   # #     #   # # # #     # #   #   # #     #     # #               #     #           #   # #
 ##### # # #####            ## # # #####           ##### # # # # ##### ####### ### ### # ##### # # ######### # # ####### # # # # ##### # # # # # ##### ##### # # # ####### ### ##### #           # ### #
 #     # # #                 # # # #                 #   # #   #       #       # #   #   #   #   # # #     # # # #       # #   #   #   # # # #   #   #     # # # #   #   #   #     # #             #   #
 ####### ### ####          # # ### # # ### # ####### # ### # ########### ####### ### # ### # ##### # # ### # # # # ####### ####### # ### ### ##### # ##### # # # ### # # ##### ### # #           ### ###
       #                   # #   #   #   #     #   #   #   # #   #     # #       # # # # # #   #   #     #   # # #     #     #     #   #     #     #   # # # # #   # # #     #   # # #           #   # #
###### # ########          #          ## ##### # ####### ### # # # # # # # # ### # # # # # ### # ####### ##### # ##### # ### # ####### # ####### ##### # # # # # ### # ##### ### # ###           ### # #
 #   # #     #             #           #       #         #   # # # # #   # # #     # #   # # # #     # # #   # # #   #   # # #   # #   #         #   #   # #   #     # #       # #     #   #   #   #   #
 # # # # ##### ##          #           ############# ##### ### ### # ####### # ##### ### # # # ##### # # # # ### # # ##### # ### # # ############# ### ### ##### ##### ####### # ########### # ### ### #
   #   # #     #                       #             #     #       # #       # #     #   # # # #   # #     # #   # #   #     #   #       #   #     #   #   #   #     #     # # #           # #   #   # #
 ####### # ##### # # ##### #          ## ####### ### ##### ######### ### # ##### ##### ### # # # # # ####### # ### ### # ##### ######### # # # ##### ### ### # ##### ##### # # ### ####### ##### ### # #
 #       #   #     #     # #             # #     #   #   # #     #   #   # #   #     # # # # #   # #     #     # #   #   #   # #       # # # #         # #   # #   #       #   #   #     #       #   # #
 ####### ### # ######### # #           ### # ######### # # # ### # ### ### # # ##### # # # # ##### # ### ####### ### ##### # # # # ##### # # # ######### # # ### # ######### ####### ### ####### # ### #
       #   # # #     #   # #               #           # # # # #   #   #   # # #     #   # #     # # # #       #     #     #   # #     #   # #   #       # # #   #     # #   #       # #     # # # #   #
###### ### # # ### ### # # #          ############ ##### # # # ##### # ##### # # ##### ### # ### # # # ####### # ##### ######### ##### ##### ##### ####### ### ##### # # # ##### ##### ##### # # # #####
     # # # # #   #   # # # #               #     # #     #   #     # #       # #     # #   #   # # #   #   #   #     #   #     # #   #   #   #     #     #   #   #   #   #   #   #         # # # #     #
 ### # # # # ### ### # # # # # ### # # ### # ### ### ######### ### # ######### ##### ### ####### # ##### # # ####### ### # # ### # # ### # ### ##### ### # # ### # ##### ### # ### ####### # # # ##### #
   #   #   #   #     # # # # # #   # # #   # #     #   #       #   # #       #       #   #       #       # #       #   # # #     # #   #   #   #   #   # # #   # #   #     # # #   #       # #       # #
## ##### ##### ##### # ### # # ### # # # ### ##### # # # ### ####### # ##### ######### ### ############### # ##### ### # ##### ##### # ##### # # # ### # # ### # ### # ##### # # ### ####### ######### #
   #   #     #   # # # #   # # #   # # #   #   #   # # # # #   #   # #     #         # #     #     #     # # #   #   # #     #     # #   #   #   # #   # #   #   # # #   #   # # # #   #   # #   #     #
 ### # ######### # # # # ##### # ### # ### ### # ##### # # ### # # # ########### ### # # ### # # ### # ### ### # ### # ##### ##### # ### ######### # ####### ##### # ##### ### # # ### # # # # # # ### #
     #           #   #         #       #       #       #     #   #               #     #   #   #     #         #     #       #       #             #               #           #     #   #     #   #   #
########################################################################################################################################################################################################