########################################################################################################################################################################################################
 # #     #   #     #     #         #                         #         #           #           #       #               #       #     #     #                     #           #   #           #         #
 # # # # # # # ### # # ### ### ##### ####### ##### ######### ####### # # ##### # ### ##### ### ### ### # ##### ####### # ##### ### # # # ### ### ############### ##### ##### # # # ##### ### ####### ###
 #   # # # #   #   # #       # #     #     # #   #     #   #       # # #   # # # #   #   # # #   #   # # # #   #     #   #   #   # # # #       # #             #       #     # #       # # #       #   #
 ### # ### ##### ### ####### # # ##### ### # # # ### # # # ####### # # ### # # ### ### ### # ### ### # # # # ### # ####### # ### # ### ######### # ########### ####### ##### # ######### # ####### ### #
   # #     #   #     #     # #   #   # # # # # #   # #   #   #   #   #   #   #     #   #   #   # #   # # # # #   # #   #   # #   #     #   #   #             #     #   #   # # #         # #     #     #
## # ######### ####### ### # ##### # # # # ### ### # ####### # # ####### ### ####### ### ### ### # ### # # # ### # # # # # # # ### ##### ### # ################# # ### # # ### # ####### # # ### ##### #
   # #         #       #   #   #   # # # # #   # # #   #     # #   #     #   #     #   #   #       #   #   #   # # # #   # # # #   #     #   #         #       # #   # # #     #     #   #   # #     # #
 ### # ##### ### ####### ####### ### # # # # ### # # ### ####### ### ##### ##### # # # ### ####### ##### ##### # # # ##### # # ### # ##### ########### # ##### ##### ### ########### ##### ### ### # # #
   # # #   #   #     # #         # # # #   #   # # # #   #   #   #   #   # #     # # #   #     #   #   # #     # # # #     # #   # #   #   # #       # # #         #   #     #     #     #   #   # # # #
## # ### # ### ##### # ########### # # ### ### # # # # ### # # # # ##### # # # ##### ### ##### # ### # # # ##### ### # ######### # ### # ### # ### ### # ######### # # ##### # ### ##### ### # ### ### #
   #     #     #   # #             # #   # #   # # # #   # #   # # #     # # # #   # #     #   # #   # # #   #   #   #           #     #   # #   #     #       #   # #     #   #   #   #   # #   #     #
 ############# # # # # ### ##### ### ### # # ### # ##### # ####### # ##### # # # # # # ### # ##### ### # ### # # # ################### ### # ### ####### ##### # ######### ##### ### # ### # ### #######
 #           # # #   # #   #     #   #   #   #   #   #   #   #     #   #   # #   # # #   # # #     # #   # # # #       #   #   #     # # # #   # #       #   # #         #   #   #   #     #     #     #
 ######### ### # ##### # ### ##### ### ####### # ### # ### # # ##### # # ### ##### # ### ### # ##### ##### # ######### # # # # # ### # # # # ### # ####### # # ### ##### # ### ### # ########### # ### #
 #       #     #   #   #   #   #   #   #       #   # #   # # #   #   #   #   #   #     # #   # # #         #         #   #   # #   #     # # #   #     #   # # #   #   # #       # # #   #     #   #   #
 # ##### ####### # ### ### ### # ### ##### # ##### # ### # # ### ### ######### # ####### # ### # # ##### # ######### ######### ######### # # # ####### # ##### ##### # # ######### # # # ##### ##### ###
   #     #     # #   #   # # # # #   #   # #   #   #     # #   #   #           #     #   # #   # # #     # #       # #       #         # # #       #   #     # #     # #     #     # # #     #   #   # #
#### ##### ### ##### ##### # # # # # # # ### # # ######### ### ### ################# # # # # ### # # # ##### # ### # # ############### # # ####### # ####### # # ##### ##### # ####### ##### # # # ### #
   #       # #   #   #   # #   # # # # #   # # #   # #     # #   # #     #   #   #     # # #   # # # # #   # #   # # #           #     # #     #   #         #   #   #     #   #   #   #   # # # #     #
 # ######### ### # ### # # ##### # ### ### # # ### # # ##### ### # # ### # # # # # ####### ### # # # ### # # ### ### # ####### ### ##### ##### # ### ####### ##### ####### ##### # # ##### # ### ##### #
 #         #   #   #   #   #     #       # # # #     # #       # #   # # # # # #   #     #     #   #   # #     # #   #   #     #   #   # #     #   # #   # # #           #   #   #       # #   # #   # #
## ### ##### # ##### ##### # ##### ####### # # ##### # ### ##### ##### # # # ####### ### # ########### # ####### # ##### # ### # ### # ### ####### ### # # # # ##### # ##### # ######### # ### # # # # #
   #   #     #   # #     # # #   #     #   # #     # #   # #     #     #   # #     # # # #           #   # #     # #   # #   # #     #   # #     # #   # #   #     # # #   #   #     # # #   # #   #   #
 ####### ### ### # # ### ### # ### ##### ##### ### # ### # # ##### ### ##### # ### # # # ########### ### # # ### # # # # ### ########### # # ### # # ### ### ####### # # # ### # ### # # # # # # #######
           # # # # #   # #   # #   #   # #     #   #   #   #         # #   #   # # # # #       #   #   #   # #   #   # # # # #         # # #   # # #   #   #   #     # # #   # # # # # # # # # #     # #
 ######### # # # # # ### # ### # ### # # ### ### ######### ######### # # # ##### # # # ####### # # ### # ### # ####### # # # # ##### ### # ##### # ### ### ### # ##### # ### ### # # # # # # # ##### # #
     #   # # #   #   #   # #       # # #   #   #           #       # #   # #     # # #     #   # # #   # #   # #       # # #   #   # #   #     #       # #   #   #   # #   #   # #   #     # #   #     #
#### # # ### # ####### # # ######### # ### ############### # ##### # ##### # # ### # # ### # ### # # ### # ### # ####### # ####### # # ####### ######### ### # ### # ##### ### # # ########### # ##### #
 #   # #   # # #       # # #         #   #     #         # # #   # #     #   #   # # # # #   #   # #   # #   # #     # # #         # # #     #   #       #   # #   #       # #   # #     #   # #   #   #
 # ### ### # # # ##### ### # ########### ##### # ####### ### ### # ##### ####### # # # # ##### ### ### ##### ####### # # # ### ### # # # ### ### # ####### ##### ########### ##### ### # # # ### # #####
   # # #   # # #   #   #   # #     #   # #   # #   #   # #   #   # #   # #       #   #     #   #     #           #   # # # # #   # #   # # #     #   #   #     #       #   #   #   #   # # #   # #     #
 ### # ### # # ### ### # ### # ##### # # # # # ### # # # # ### ### ### # # ##### ######### # ####### ######### ### ### # # # ### # ##### # ######### # # ##### ####### # # # ### ### ### # ### # ##### #
     #   #   #   #   # # #   #   #   #   # # #     # # # #   #   #   #   #   #   #       # # #   #   #         #   #   # #   # # #       #           # #     #         # #     #   #   # # #   #   #   #
######## ####### # # ### # ##### # ####### # # ##### ### ### ### ### ##### # ##### ##### # # # # # ### ######### ### ### ### # # ########### ####### # ##### ########### ##### ### ### # # # ### ### # #
         #       # #   # # #     #   #   # # #       #     # #     #     # # #     #   # # # # # # #       #   #   # #   #     #   #         #       # #   #   # #     # #     # #   # #   #   # #   # #
 ######### ########### # # # # # ### # # # # ####### # ##### # ### ##### ### # ##### # # # # # # ### ####### # # # # # ####### ### ### ### ########### # ### # # # # ### # ### # ### # ####### # # ### #
   #     # #           #   # # #   #   # # # #   #   #         #   #     #   # #     # # # # # #   #   #     # # # # #       #   #   # # #           # # #   # #   #   # # # # #     #       # # #   # #
## ##### # # ####### ####### # ######### # # ### # ################# ##### ### ### # # # # # # ### ### # ##### ### # ####### ### ### # # ########### # # # ### # ##### # # # # # ########### # ### # ###
   #     # #       # #   #   #     #   #   # #   #   #   #           #       #   # # # #   #   # #     # #   #     #   #   #   # # # #   #   #     #     # # # # #   #   # # # # #     #     #   # #   #
 ### ##### # ##### # # # # ####### # # ##### # ### ### # # ################# ### # # ####### ### ####### # # ####### # # ##### # # # ### # ### # ####### # # # ### # ##### # # # # # # # ####### # ### #
 #         #   # # # # #   #     # # #   # # #     #   #   #       #     #     # # #       # #   #     #   #     #   #   #   # #   #   # #     #   #   # # # #     #     # #   # # # #   #   #   # #   #
 # ########### # # ### ##### ### # # # # # # # ##### ########### # # ### # ##### ##### ### # ### # ### ######### # # ### # # # # ##### # ######### # # ### # ########### # # ### # # ##### # # ### # # #
 # #   #     # # #       #   # # #   # # # # #     # #         # # # # #   #   #       # # #   #   # #   #     # # #   # # #   # #     #         # # #     # #         # # # #   # # #     # # #   # # #
 # ### # # # # # ######### ### # # ### # # # ####### # ### ### # # # # ### # # ######### # ### ### # ### # ### # ##### # # ##### # ############# # # ####### # ##### ### # # # ### # ##### ### ##### # #
 #   # # # # # # #       #   # # # #   #   # #       #   # #     #   #   # # # #       #   #     #     #     # #     # # # #   # # #   #       #   #   #     #     #       # # #   # #   #           # #
 ### # # # ### # # ##### ### # # ### # ##### # ######### # ########### ### # # # # ### # ####### ############# ##### # # # # # # # ### # ##### ### ### # ### # ############### # ### # # # ####### #####
   # #   #   # # # #   #     #       # #   #   # #       #   # #           # #   # #   #   #   #             #   #   # # # # # # #   # # #   # #   #   #   #   #         #   # # # #   # #   #   # #   #
 # # ##### # # # # # # ############### # # ##### # ####### # # # ########### ##### ### ### # # # ########### # ### ### ### # # # ### # # # # # # ### ######### # ##### ### # # # # ##### ##### # ### # #
 # #     # #     # # #     #     #     # #     #   # #   # # # # #     #   # #   #   # # #   # # #     #   # #   #   #   # # # # #   #   # #   #   #   #     # #     #     #   #     # #     # #   # # #
## ##### ####### # ### ### # # ### ##### # ### # ### # # ### # # # ### ### # # ##### # # ##### # # ### # # # ### ### # # # # # # # ##### # ####### ### # ### # ##### ############### # ##### # ### # # #
   #   #       # # #   #     # #   #   # # #   #   # # # #   #   # # #     # #   #   #       # # #   # # # #       # # #     # # #     # #           #     # #   # #   #     #     #   #   # # # #   # #
 ### # ####### ### # ######### # ### ### # # ##### # # # # ### ### # # ##### # # # ########### # ### # ### # ####### ######### # ##### ##################### ### # ### # ### ### # ### # # # # # ##### #
     #     #       # #     #   #   # #   # #   #     # # #   #   # #   #     # # #     #       #   # #   #   #     #     #     #   #   #     #           #   #       # #   #     #   # # # #   #   #   #
 ######### ######### # ### ### ### # # ### ### # ##### # ### ### # # ### ####### ##### # ######### # ### ##### ### # ### # ####### # ### ### # ######### # ######### # ### ######### ### # # ### # # ###
   #     #   #       #   #   # #   # #   # #   #   #   #   # #   # #   # #       #   #   #       # #   #       #   #   # # #       #   # #   # #       #   #     # # #     #   #   # #   # #   # # #   #
## # ### ### # ####### ##### # # ### ### # ### # ### ##### # # ### ### # ### ### ### ##### ### # ##### ######### ##### # # ####### ### # # ### # ##### ##### ### # # ####### # ### # # ### ### ### ### #
   #   #   # #     #   #     # #   #   # #   # # #   #   #   # #     # # #   #           # # # # #   # #     #   #   # # #       #   #   # #   # # #   #     # # #   #       #     #   #   # #     # # #
 ##### ### # # ### # ### ##### ### # ### ### # ### # # # ##### ##### ### # ####### ####### # # # # # # # ### # ##### # # ####### ######### # # # # # # # ##### # # ##### # ############# ### ##### # # #
   #   #   # # #   # # #     #   # # #   # # #     # # # #   # #     #   #   #   # #       # # #   # # # #   #     #   #       #   #       # # # # # # #   #   # #   #   # #           #   #       # # #
## # ### ### # # ### # ##### ### # # # ### # ######### # # # # # ##### ##### # # ### ##### # # ##### # ### ####### # ######### ### # ####### ### # # ##### # # # ### # ### # ######### ### ####### # # #
 #   #   #   # #         #   #   # # #     #   #       # # #     #   #     #   #     #   # # #     #   #   #       #       #   #   #       #     # #     # # # #   #   #   # #       #   # #     #   # #
 ##### ### ### ######### # ### ### # ##### ### # ####### # ####### # ##### # ######### # # # ##### ##### ### ############### ### ### ##### # ##### ##### # # # ### ### ##### # ##### ### # # ### ##### #
     #   #   #   #   #   #   # #         #   #     #     # #       #     # # #   #     # #   #   # #   #     #             #   # #       # #   #   #   #   # # # # #   #     #   #     #   #   #     # #
 # ##### ### ### # # ####### ### ########### ####### # ##### ########### # # ### # ##### ### # # # # # # ##### ########### # # # ####### # ### # # # # ##### # # # ##### ####### # ### ##### # ##### # #
 # #   #   #   # # #       #     #     #         #   # #   #     #     #   #     # #   #   # # # # # # # #   #   # #     # # # #   #   # # #     # # #       # # #       #   #   #   # #   # # #   # # #
 ### # ### ### ### ####### ##### # ### # ######### ##### # ##### # # # ####### ### # # ### # # ### ### # # # # # # # ### # ### ### # # # # ####### ##### ##### # ######### # # ##### # # # # # # # # # #
 #   #   #   # #   #     #     # #   #   # #       #   # # #   # # # #       # #   # #     #   #   #   #   # # # # #   # # #   #     # # #   #     #     #     #   #       # #   #   # # # # # # # # # #
 # ### ##### # # ### ######### ##### ##### # ####### # # # # # # ### ####### ### ### ########### ### ####### ### # ### # # # ######### ##### # ##### ##### ####### # # ######### # ##### # # # # # # # #
 #   #       # # #   #       #       #     #         #   #   # #   #   #   #     # # #           #       # #     #   # #   #     #   #       # #     # #   #       # #           #     # #   # # # #   #
 ### ######### # # # # ### ############### ################### ### ### # # ####### # # # ######### ### # # ######### # ##### ### ### ######### # ##### # ##### # ### ########### ##### # ##### # # ### #
   # #   #     # # #   # #                 #     #       #     # #     # #   #   #   # #   #     # # # #   #         # # #   #   #   #       #   #       #   # #   #     #     # #   #     #   # #   # #
 ### # # # ##### # ##### ############# ### # ### ####### # ### # ######### # # ### ####### # # ### # # ### # ### ### # # # ### ### # # ### # ##### ####### # ### # # ##### ### # # # ####### ### ### # #
 #   # # #   #   # #     #     #       #   # # #         #   # #       #   #   #   #     # # # #   # #   # #   # #   # #   #   #   # # # # # #     # #     #   # # # #     #   # # #     #   #   # # # #
 # ##### ### # ### ##### # ### # ####### ### # ####### ##### # # ### # # # ##### ##### # # # ### ### ### ##### # # ### # ### ### # ### # # # # ##### # ### ### # # # # ##### ##### ##### # ### ### # # #
 # #   #   # #   # #     # # # # #   #   #   #   #     #     # #   # #   # #   #     # # # #   # #     #     # # # #   # #   #   #   #   # # #   #       # #   # #   #     #       #     #         # # #
 # # # # ### ### # # ##### # # # # # # ### # ### # ##### ######### # ### ### # ##### # # # # # # # ### ##### # # # # ##### ### ##### ### # ##### ######### # ############# ######### ##### ######### ###
 #   # #   #   # #   #     # # # # # #   # #   # # # #   #   #   # # #   #   # #   # # #   # # # # #   #   #   # # # #   #   #   # #   # #     #   #   #   # #   #       #       #   #   #   #     #   #
 ##### ### # ### ##### ##### # # # # ### ##### # # # # ### # # # # # ##### ### # # # # ##### # # ### # ### ##### ### # # ### ### # ### # ##### ### # # # ### # # # ##### ####### # ### # ##### ### ### #
           #           #         # #           #     #     #   #   #         #   #     #     #       #         #       #     #       #       #       #   #     #   #             #     #       #       #
########################################################################################################################################################################################################